DATE,PRODUCT_ID,PRODUCT_NAME,FORCASTED_SALES,ACTUAL_SALES,,Accuracy
30-12-2015,55725,CEDAR15HSWBTX,87,43,44,51%
15-08-2017,60147,TULIP15BDWBTX,3,40,-37,-1233%
01-03-2015,59515,BELMONTBTX,11,28,-17,-155%
16-02-2016,57455,TITAN14MLKBDWBTX,59,11,48,81%
24-02-2017,59515,BELMONTBTX,78,85,-7,-9%
31-07-2016,53291,DIESEL 15,79,79,0,0%
22-11-2015,63395,ECHO 13 MLK CTO,52,72,-20,-38%
13-10-2017,199,PARTS,48,40,8,17%
10-09-2016,81734,PR54220MIRMAR15A,87,6,81,93%
23-08-2015,62907,BEAVERCREEK14BTX,50,58,-8,-16%
14-05-2016,62907,BEAVERCREEK14BTX,22,60,-38,-173%
28-01-2015,60813,BERLINETTABTX,27,31,-4,-15%
13-10-2017,62904,BEAVERCREEK12BTX,58,51,7,12%
26-03-2016,66803,SOMERSETBTX,44,21,23,52%
21-02-2017,199,PARTS,26,81,-55,-212%
22-09-2017,62904,BEAVERCREEK12BTX,63,67,-4,-6%
30-01-2016,62907,BEAVERCREEK14BTX,58,4,54,93%
02-02-2017,60151,TULIP17SKLBTX,42,67,-25,-60%
06-04-2016,60146,TULIP14BDWBTX,66,29,37,56%
07-12-2017,62853,PARKCITY14BTX,38,70,-32,-84%
30-03-2016,62853,PARKCITY14BTX,92,32,60,65%
01-03-2016,62853,PARKCITY14BTX,47,82,-35,-74%
15-09-2016,75357,PR50416ERIKSNATG,19,35,-16,-84%
11-09-2015,199,PARTS,43,79,-36,-84%
13-10-2015,60147,TULIP15BDWBTX,2,44,-42,-2100%
20-03-2016,62907,BEAVERCREEK14BTX,52,72,-20,-38%
01-09-2016,59860,SILVERTONBTX,51,47,4,8%
20-06-2016,52370,SALADO 14,37,12,25,68%
24-06-2017,62853,PARKCITY14BTX,92,18,74,80%
09-04-2017,199,PARTS,34,33,1,3%
28-12-2017,62853,PARKCITY14BTX,90,43,47,52%
25-12-2016,62908,BEAVERCREEK14CTO,88,51,37,42%
03-07-2015,60147,TULIP15BDWBTX,11,3,8,73%
20-12-2017,62853,PARKCITY14BTX,61,95,-34,-56%
28-08-2016,60147,TULIP15BDWBTX,68,85,-17,-25%
10-09-2017,62853,PARKCITY14BTX,54,15,39,72%
31-01-2015,57513,HOUSTON12BTX,52,52,0,0%
02-05-2017,57453,JANUS15HSWBTX,28,63,-35,-125%
05-06-2015,63397,ECHO 15 MLK CTO,18,96,-78,-433%
03-09-2016,70901,ROCKET11BSWBTX,9,33,-24,-267%
21-04-2017,63886,PANDORA15SKLBTX,100,35,65,65%
01-09-2015,70901,ROCKET11BSWBTX,42,33,9,21%
19-11-2017,70901,ROCKET11BSWBTX,6,43,-37,-617%
25-11-2017,62880,LOVELAND15SCTO,73,6,67,92%
09-04-2016,57368,FIGTREECTO,33,89,-56,-170%
19-12-2016,54142,TESTAROSSA P,7,72,-65,-929%
23-05-2017,58169,ECHO 15FCTO,81,31,50,62%
06-10-2016,57616,CRESTED BUTTEBTX,33,98,-65,-197%
24-09-2016,66803,SOMERSETBTX,1,99,-98,-9800%
15-04-2016,60147,TULIP15BDWBTX,64,32,32,50%
04-04-2016,62882,LOVELAND14SCTO,36,67,-31,-86%
13-07-2015,64248,JAYTONBTX,73,11,62,85%
21-07-2017,57453,JANUS15HSWBTX,92,70,22,24%
30-10-2016,62854,PARKCITY14CTO,75,20,55,73%
03-07-2015,57453,JANUS15HSWBTX,23,50,-27,-117%
26-09-2015,56744,MARBLE FALLS14BTX,8,18,-10,-125%
08-09-2017,62905,BEAVERCREEK12CTO,17,51,-34,-200%
12-07-2015,57366,FIGTREEBTX,34,66,-32,-94%
11-01-2017,62877,LOVELAND14BBTX,63,20,43,68%
19-07-2015,74129,PR49790GOL14MLKA,63,25,38,60%
21-11-2016,199,PARTS,12,64,-52,-433%
23-10-2015,60812,VENENOBTX,19,79,-60,-316%
08-02-2017,199,PARTS,69,64,5,7%
18-01-2016,57453,JANUS15HSWBTX,51,88,-37,-73%
27-05-2016,64250,JAYTONSECUREBTX,68,11,57,84%
15-07-2015,199,PARTS,89,91,-2,-2%
17-04-2015,57283,COTTONWOODBDWBTX,43,4,39,91%
30-11-2016,62850,PARKCITY12BTX,29,19,10,34%
15-04-2016,64248,JAYTONBTX,30,99,-69,-230%
02-11-2017,60704,VANGOGH14BDWBTX,83,21,62,75%
01-03-2016,55727,CEDAR14BDWBTX,53,7,46,87%
29-09-2016,64248,JAYTONBTX,1,56,-55,-5500%
16-11-2016,62856,PARKCITY15BTX,3,3,0,0%
31-07-2016,60813,BERLINETTABTX,21,29,-8,-38%
30-09-2017,75570,PR50510DIESEL17,81,83,-2,-2%
02-06-2017,61333,BERLINETTA P,59,9,50,85%
10-12-2017,57616,CRESTED BUTTEBTX,95,6,89,94%
30-07-2017,57616,CRESTED BUTTEBTX,59,47,12,20%
06-03-2017,62851,PARKCITY12CTO,86,83,3,3%
09-10-2015,57616,CRESTED BUTTEBTX,51,79,-28,-55%
17-04-2017,55725,CEDAR15HSWBTX,5,78,-73,-1460%
29-12-2017,63251,BLACKWOODSKLBTX,61,22,39,64%
02-01-2017,62878,LOVELAND14BCTO,78,92,-14,-18%
12-05-2015,74360,IRIS15AMDBTX,97,58,39,40%
25-05-2015,62881,LOVELAND14SBTX,86,72,14,16%
05-08-2017,55728,CEDAR15BDWBTX,81,3,78,96%
19-05-2017,62907,BEAVERCREEK14BTX,100,19,81,81%
10-02-2017,62881,LOVELAND14SBTX,86,39,47,55%
04-07-2016,75863,PR50769SILVERTON,29,84,-55,-190%
12-12-2015,52370,SALADO 14,88,56,32,36%
05-01-2016,55725,CEDAR15HSWBTX,54,100,-46,-85%
03-04-2016,61590,DINO2BTX,80,19,61,76%
05-06-2017,60147,TULIP15BDWBTX,73,35,38,52%
05-11-2016,60146,TULIP14BDWBTX,47,2,45,96%
20-08-2016,55725,CEDAR15HSWBTX,21,72,-51,-243%
04-11-2017,62878,LOVELAND14BCTO,56,57,-1,-2%
16-12-2017,57191,ERIKSSON14CTO,22,58,-36,-164%
03-08-2017,64248,JAYTONBTX,35,80,-45,-129%
12-07-2015,199,PARTS,10,22,-12,-120%
07-02-2016,57527,HOUSTON15CTO,98,2,96,98%
10-10-2017,57527,HOUSTON15CTO,2,12,-10,-500%
27-09-2016,63276,MAPLE15SKLBTX,29,58,-29,-100%
31-01-2015,60707,VANGOGH15SKLBTX,36,19,17,47%
28-02-2015,57525,HOUSTON15BTX,69,81,-12,-17%
04-01-2015,57525,HOUSTON15BTX,68,17,51,75%
10-06-2016,57191,ERIKSSON14CTO,9,27,-18,-200%
12-07-2016,57513,HOUSTON12BTX,100,11,89,89%
21-11-2015,62851,PARKCITY12CTO,61,51,10,16%
23-02-2016,60147,TULIP15BDWBTX,91,4,87,96%
28-12-2017,83963,PR55474LIVNGSTON,72,25,47,65%
26-02-2017,61341,MIRAMAR 17,54,74,-20,-37%
21-09-2016,57525,HOUSTON15BTX,79,97,-18,-23%
30-06-2016,57513,HOUSTON12BTX,1,29,-28,-2800%
08-02-2017,62905,BEAVERCREEK12CTO,61,61,0,0%
28-07-2016,77339,PR51386HOUSTN14O,33,80,-47,-142%
21-02-2015,57526,HOUSTON15CTOE,28,88,-60,-214%
09-11-2017,57617,CRESTED BUTTECTO,100,48,52,52%
30-08-2016,57379,JEFFERSONBTX,13,5,8,62%
16-02-2016,199,PARTS,88,60,28,32%
04-12-2016,54984,ROUND ROCKBTX,12,4,8,67%
09-04-2016,60153,TULIP15AMDBTX,18,15,3,17%
28-03-2015,52370,SALADO 14,63,92,-29,-46%
31-07-2015,74360,IRIS15AMDBTX,6,86,-80,-1333%
13-06-2016,57623,CRESTEDBUTTECTO1,9,93,-84,-933%
15-04-2017,57379,JEFFERSONBTX,68,86,-18,-26%
02-03-2015,52375,SALADO 14 CTO,16,89,-73,-456%
18-07-2016,57379,JEFFERSONBTX,81,50,31,38%
21-05-2016,57379,JEFFERSONBTX,91,64,27,30%
16-03-2015,57379,JEFFERSONBTX,56,36,20,36%
22-08-2016,199,PARTS,21,39,-18,-86%
03-02-2016,199,PARTS,12,5,7,58%
12-08-2016,62908,BEAVERCREEK14CTO,18,95,-77,-428%
11-03-2016,59515,BELMONTBTX,13,65,-52,-400%
16-08-2017,199,PARTS,84,9,75,89%
01-03-2016,60146,TULIP14BDWBTX,23,82,-59,-257%
21-12-2016,57379,JEFFERSONBTX,81,6,75,93%
11-12-2016,57379,JEFFERSONBTX,6,54,-48,-800%
01-01-2016,57379,JEFFERSONBTX,76,57,19,25%
29-08-2017,199,PARTS,85,45,40,47%
31-12-2017,60150,TULIP15SKLBTX,16,46,-30,-188%
18-03-2015,62883,LOVELAND15BCTO,84,10,74,88%
20-04-2017,77340,PR51377HOUSTN14A,68,49,19,28%
21-01-2016,60150,TULIP15SKLBTX,34,69,-35,-103%
20-08-2017,199,PARTS,71,9,62,87%
04-07-2017,199,PARTS,46,43,3,7%
23-07-2017,199,PARTS,51,80,-29,-57%
04-12-2016,57616,CRESTED BUTTEBTX,45,90,-45,-100%
29-10-2017,199,PARTS,66,44,22,33%
03-11-2017,199,PARTS,91,59,32,35%
03-11-2016,61590,DINO2BTX,62,39,23,37%
12-06-2016,61590,DINO2BTX,7,98,-91,-1300%
20-11-2016,56744,MARBLE FALLS14BTX,59,66,-7,-12%
07-11-2017,61590,DINO2BTX,37,74,-37,-100%
20-10-2017,81734,PR54220MIRMAR15A,41,84,-43,-105%
23-11-2017,57525,HOUSTON15BTX,57,100,-43,-75%
20-03-2015,57495,GOLIADMLK12CTOE,94,67,27,29%
12-08-2016,57455,TITAN14MLKBDWBTX,5,30,-25,-500%
15-02-2017,57525,HOUSTON15BTX,78,89,-11,-14%
23-10-2015,199,PARTS,38,40,-2,-5%
24-05-2016,52375,SALADO 14 CTO,72,44,28,39%
06-05-2016,56151,MAGELLAN14CTO,35,25,10,29%
26-08-2016,56151,MAGELLAN14CTO,87,70,17,20%
30-10-2016,59515,BELMONTBTX,99,98,1,1%
30-07-2015,55725,CEDAR15HSWBTX,34,6,28,82%
15-11-2015,55725,CEDAR15HSWBTX,98,40,58,59%
05-10-2016,55725,CEDAR15HSWBTX,36,63,-27,-75%
13-06-2017,62907,BEAVERCREEK14BTX,88,84,4,5%
10-06-2017,66803,SOMERSETBTX,97,37,60,62%
23-02-2015,78661,PR52109HOUSTN14A,33,36,-3,-9%
26-08-2016,59384,IRIS15BDWBTX,84,4,80,95%
08-05-2016,199,PARTS,44,16,28,64%
31-07-2017,62881,LOVELAND14SBTX,80,50,30,38%
22-09-2017,57527,HOUSTON15CTO,88,74,14,16%
22-12-2015,199,PARTS,9,37,-28,-311%
20-09-2016,66803,SOMERSETBTX,79,39,40,51%
14-05-2016,66803,SOMERSETBTX,19,99,-80,-421%
13-06-2017,62881,LOVELAND14SBTX,77,7,70,91%
17-12-2017,199,PARTS,54,15,39,72%
01-11-2016,62876,PARKCITY15TAA1,97,39,58,60%
25-12-2016,66803,SOMERSETBTX,84,86,-2,-2%
17-09-2015,62881,LOVELAND14SBTX,95,11,84,88%
15-06-2015,62881,LOVELAND14SBTX,73,80,-7,-10%
20-11-2016,199,PARTS,3,14,-11,-367%
28-01-2016,68337,ROUND ROCKMLKBTX,45,45,0,0%
02-02-2017,60707,VANGOGH15SKLBTX,20,51,-31,-155%
05-09-2015,55725,CEDAR15HSWBTX,30,45,-15,-50%
17-08-2016,61590,DINO2BTX,72,98,-26,-36%
13-08-2016,60150,TULIP15SKLBTX,70,92,-22,-31%
31-10-2017,199,PARTS,55,97,-42,-76%
24-05-2015,54983,ROUND ROCK,71,75,-4,-6%
12-01-2016,62881,LOVELAND14SBTX,100,81,19,19%
11-01-2017,52370,SALADO 14,74,42,32,43%
11-02-2017,52370,SALADO 14,64,17,47,73%
07-05-2017,74125,PR49640GOL12MLKA,40,32,8,20%
27-12-2015,52357,SALADO15TAA1,11,68,-57,-518%
13-05-2015,56157,COLUMBUS12CTO1,95,51,44,46%
08-03-2017,199,PARTS,89,82,7,8%
11-11-2017,77005,PR45058HOUSTON12,60,36,24,40%
16-08-2016,69981,PR47228CRESBUTEO,36,19,17,47%
02-03-2017,63036,MIRAMAR17TAA1,12,86,-74,-617%
26-09-2017,68337,ROUND ROCKMLKBTX,39,45,-6,-15%
07-08-2017,68337,ROUND ROCKMLKBTX,69,56,13,19%
04-07-2017,59384,IRIS15BDWBTX,84,36,48,57%
24-09-2016,62856,PARKCITY15BTX,73,34,39,53%
14-11-2016,62856,PARKCITY15BTX,50,17,33,66%
13-09-2015,62856,PARKCITY15BTX,71,47,24,34%
10-01-2017,62856,PARKCITY15BTX,28,84,-56,-200%
10-06-2016,55758,MAPLEM15BDWBTX,14,75,-61,-436%
28-02-2015,199,PARTS,8,68,-60,-750%
25-01-2015,63886,PANDORA15SKLBTX,27,30,-3,-11%
01-10-2016,63886,PANDORA15SKLBTX,49,35,14,29%
27-06-2017,82596,PR54619PKCTYP15O,37,15,22,59%
26-10-2016,199,PARTS,67,89,-22,-33%
07-01-2017,199,PARTS,5,51,-46,-920%
04-04-2017,199,PARTS,51,45,6,12%
25-02-2016,62853,PARKCITY14BTX,61,58,3,5%
13-12-2015,55758,MAPLEM15BDWBTX,11,28,-17,-155%
31-12-2016,70901,ROCKET11BSWBTX,57,67,-10,-18%
09-12-2015,53302,DIESEL17GREYFED,84,60,24,29%
21-04-2016,199,PARTS,19,73,-54,-284%
26-12-2016,60147,TULIP15BDWBTX,98,63,35,36%
21-04-2017,473,NON_TIED_PERIPHERALS,47,33,14,30%
03-02-2017,55758,MAPLEM15BDWBTX,25,84,-59,-236%
12-05-2017,69923,CELTICBTX,40,58,-18,-45%
02-06-2015,63251,BLACKWOODSKLBTX,72,100,-28,-39%
15-06-2016,63251,BLACKWOODSKLBTX,56,65,-9,-16%
24-04-2017,63251,BLACKWOODSKLBTX,96,26,70,73%
28-04-2015,55758,MAPLEM15BDWBTX,36,54,-18,-50%
09-02-2017,53512,GOLIAD 14,95,84,11,12%
27-04-2016,60147,TULIP15BDWBTX,26,98,-72,-277%
18-05-2016,60147,TULIP15BDWBTX,59,31,28,47%
14-05-2015,57368,FIGTREECTO,84,16,68,81%
05-01-2016,70899,PR29256CRESBUTTE,68,13,55,81%
26-07-2017,199,PARTS,44,64,-20,-45%
31-03-2017,60150,TULIP15SKLBTX,57,67,-10,-18%
17-09-2015,61590,DINO2BTX,47,79,-32,-68%
20-05-2016,63886,PANDORA15SKLBTX,71,5,66,93%
09-10-2015,68337,ROUND ROCKMLKBTX,72,3,69,96%
29-12-2016,63886,PANDORA15SKLBTX,21,19,2,10%
08-11-2016,63886,PANDORA15SKLBTX,80,2,78,98%
04-02-2016,63251,BLACKWOODSKLBTX,23,25,-2,-9%
09-02-2015,57616,CRESTED BUTTEBTX,55,30,25,45%
26-06-2015,57190,ERIKSSON14BTX,28,23,5,18%
16-07-2015,57190,ERIKSSON14BTX,1,90,-89,-8900%
03-06-2016,52371,SALADO 15,36,28,8,22%
20-01-2016,60147,TULIP15BDWBTX,98,46,52,53%
01-06-2017,60147,TULIP15BDWBTX,66,46,20,30%
16-09-2017,62850,PARKCITY12BTX,63,46,17,27%
10-07-2015,60152,TULIP14AMDBTX,71,5,66,93%
08-03-2015,62850,PARKCITY12BTX,37,24,13,35%
07-02-2017,69923,CELTICBTX,34,55,-21,-62%
13-11-2017,60705,VANGOGH15BDWBTX,75,90,-15,-20%
12-11-2015,60150,TULIP15SKLBTX,72,48,24,33%
20-05-2017,69923,CELTICBTX,93,57,36,39%
02-05-2017,62877,LOVELAND14BBTX,49,81,-32,-65%
05-10-2016,60705,VANGOGH15BDWBTX,53,78,-25,-47%
11-09-2015,57623,CRESTEDBUTTECTO1,44,2,42,95%
01-02-2016,57616,CRESTED BUTTEBTX,56,91,-35,-63%
01-02-2015,61590,DINO2BTX,30,94,-64,-213%
12-07-2015,60150,TULIP15SKLBTX,46,69,-23,-50%
13-10-2017,60150,TULIP15SKLBTX,98,24,74,76%
08-06-2016,57455,TITAN14MLKBDWBTX,69,51,18,26%
29-07-2017,63095,MERIDIANBTX,88,85,3,3%
12-04-2016,60150,TULIP15SKLBTX,22,72,-50,-227%
11-06-2017,63251,BLACKWOODSKLBTX,14,86,-72,-514%
15-09-2016,63251,BLACKWOODSKLBTX,65,95,-30,-46%
28-06-2017,79343,PR52550MARFALS14,83,44,39,47%
16-10-2017,60147,TULIP15BDWBTX,52,43,9,17%
25-11-2017,72549,PR30432CRESBUTTE,72,90,-18,-25%
12-11-2015,52371,SALADO 15,88,98,-10,-11%
24-01-2016,60150,TULIP15SKLBTX,98,26,72,73%
14-05-2017,73519,PR49168HOUSTN14O,84,12,72,86%
13-05-2017,60150,TULIP15SKLBTX,62,28,34,55%
10-11-2015,70898,PR29286CRESBUTTE,47,94,-47,-100%
02-10-2017,63251,BLACKWOODSKLBTX,88,61,27,31%
26-04-2016,63251,BLACKWOODSKLBTX,59,96,-37,-63%
07-02-2016,64248,JAYTONBTX,78,48,30,38%
16-11-2015,62904,BEAVERCREEK12BTX,81,29,52,64%
07-02-2016,73785,PR49455MARFALS14,3,43,-40,-1333%
04-02-2017,62892,LOVELAND15FBCTO,2,86,-84,-4200%
10-10-2016,62870,PARKCITY12TAA1,79,5,74,94%
14-10-2017,63886,PANDORA15SKLBTX,10,25,-15,-150%
05-07-2015,63095,MERIDIANBTX,32,92,-60,-188%
26-09-2016,60150,TULIP15SKLBTX,91,43,48,53%
24-06-2016,62881,LOVELAND14SBTX,70,37,33,47%
18-08-2016,60705,VANGOGH15BDWBTX,73,63,10,14%
13-11-2016,75888,PR50798COLUMXFR,87,21,66,76%
22-12-2015,199,PARTS,88,22,66,75%
18-01-2017,57379,JEFFERSONBTX,84,93,-9,-11%
13-10-2015,57379,JEFFERSONBTX,87,81,6,7%
31-07-2015,63251,BLACKWOODSKLBTX,41,65,-24,-59%
20-05-2016,80760,PR53343ERIKSNATG,85,21,64,75%
25-02-2016,199,PARTS,79,63,16,20%
06-11-2017,63251,BLACKWOODSKLBTX,91,33,58,64%
27-09-2015,62878,LOVELAND14BCTO,83,13,70,84%
08-11-2016,56743,MARBLE FALLS14CTO,88,44,44,50%
17-07-2016,199,PARTS,95,23,72,76%
19-10-2016,61339,MIRAMAR 15,67,88,-21,-31%
11-02-2017,60705,VANGOGH15BDWBTX,56,89,-33,-59%
01-09-2017,60150,TULIP15SKLBTX,41,33,8,20%
13-03-2017,199,PARTS,11,68,-57,-518%
07-06-2017,59515,BELMONTBTX,74,65,9,12%
05-01-2017,65654,PR39219MARFALS14,98,61,37,38%
27-01-2016,60151,TULIP17SKLBTX,40,75,-35,-88%
26-08-2015,59670,PLANOBCTO,23,45,-22,-96%
23-10-2015,199,PARTS,69,37,32,46%
12-11-2017,59670,PLANOBCTO,98,48,50,51%
28-05-2016,62851,PARKCITY12CTO,74,26,48,65%
09-12-2015,61590,DINO2BTX,79,52,27,34%
23-09-2016,62904,BEAVERCREEK12BTX,26,38,-12,-46%
06-12-2015,53292,DIESEL 17,3,87,-84,-2800%
05-12-2015,62880,LOVELAND15SCTO,67,34,33,49%
03-04-2015,60813,BERLINETTABTX,76,99,-23,-30%
26-02-2017,63039,PARKCITY-P15CTO,16,83,-67,-419%
18-07-2015,69237,PR46653SALADO14,9,74,-65,-722%
21-01-2015,62882,LOVELAND14SCTO,24,65,-41,-171%
21-03-2016,63095,MERIDIANBTX,62,5,57,92%
08-05-2015,56746,MARBLE FALLS15BTX,78,58,20,26%
27-10-2015,76926,PR51307DIESEL17,86,77,9,10%
24-01-2016,60149,TULIP14SKLBTX,31,84,-53,-171%
20-03-2015,64250,JAYTONSECUREBTX,59,6,53,90%
02-08-2015,60150,TULIP15SKLBTX,62,10,52,84%
13-11-2015,60150,TULIP15SKLBTX,92,11,81,88%
30-06-2016,60150,TULIP15SKLBTX,74,95,-21,-28%
20-01-2017,60153,TULIP15AMDBTX,1,75,-74,-7400%
25-04-2015,72168,PR48340CRESBUTEA,27,1,26,96%
13-11-2015,63399,ECHO 17 MLK CTO,72,87,-15,-21%
02-03-2016,74484,PR49941GOL12MLKO,89,14,75,84%
07-04-2017,63251,BLACKWOODSKLBTX,25,18,7,28%
03-05-2017,69925,CELTICCTO,64,43,21,33%
12-08-2016,62907,BEAVERCREEK14BTX,69,16,53,77%
15-05-2017,66803,SOMERSETBTX,88,82,6,7%
24-05-2017,57379,JEFFERSONBTX,6,43,-37,-617%
01-02-2015,57379,JEFFERSONBTX,28,83,-55,-196%
17-11-2016,60705,VANGOGH15BDWBTX,74,84,-10,-14%
21-01-2015,199,PARTS,28,94,-66,-236%
11-08-2016,199,PARTS,17,57,-40,-235%
09-11-2016,60150,TULIP15SKLBTX,9,70,-61,-678%
01-07-2016,60150,TULIP15SKLBTX,23,33,-10,-43%
23-01-2016,60150,TULIP15SKLBTX,91,38,53,58%
09-05-2016,60150,TULIP15SKLBTX,92,72,20,22%
07-01-2016,60705,VANGOGH15BDWBTX,93,79,14,15%
19-04-2016,59515,BELMONTBTX,12,44,-32,-267%
23-06-2016,62904,BEAVERCREEK12BTX,15,1,14,93%
04-04-2017,199,PARTS,22,70,-48,-218%
29-08-2017,73929,DRAXBTX,74,2,72,97%
18-11-2016,62856,PARKCITY15BTX,98,93,5,5%
01-05-2016,62856,PARKCITY15BTX,74,20,54,73%
16-07-2016,199,PARTS,43,11,32,74%
16-12-2015,36029,SLINKY,86,47,39,45%
10-01-2015,62907,BEAVERCREEK14BTX,10,13,-3,-30%
19-04-2015,60150,TULIP15SKLBTX,73,80,-7,-10%
09-12-2015,59384,IRIS15BDWBTX,68,26,42,62%
14-06-2017,55758,MAPLEM15BDWBTX,55,85,-30,-55%
01-06-2017,55758,MAPLEM15BDWBTX,70,73,-3,-4%
03-07-2017,57499,GOLIADMLK14BTXE,46,5,41,89%
24-07-2015,62907,BEAVERCREEK14BTX,93,64,29,31%
20-04-2015,84457,PR55748PRKCTY15O,23,95,-72,-313%
26-05-2015,56151,MAGELLAN14CTO,49,5,44,90%
09-03-2017,56151,MAGELLAN14CTO,77,96,-19,-25%
06-09-2017,63032,BERLINETTAPTAA1,10,90,-80,-800%
07-11-2016,61341,MIRAMAR 17,73,26,47,64%
19-07-2015,62907,BEAVERCREEK14BTX,81,98,-17,-21%
28-08-2017,60705,VANGOGH15BDWBTX,76,17,59,78%
14-01-2016,61333,BERLINETTA P,69,57,12,17%
17-12-2016,62879,LOVELAND15BBTX,3,2,1,33%
11-08-2015,60825,BOLDPEAK2,81,46,35,43%
13-08-2017,62907,BEAVERCREEK14BTX,93,77,16,17%
20-02-2015,57616,CRESTED BUTTEBTX,48,75,-27,-56%
11-05-2017,63256,COTTONWOODSKLBTX,98,97,1,1%
01-03-2015,62907,BEAVERCREEK14BTX,5,62,-57,-1140%
29-08-2017,62907,BEAVERCREEK14BTX,45,54,-9,-20%
08-03-2017,79077,PR52471DIESEL15,3,46,-43,-1433%
22-10-2016,60812,VENENOBTX,77,61,16,21%
01-07-2015,63039,PARKCITY-P15CTO,11,39,-28,-255%
16-02-2015,199,PARTS,80,3,77,96%
15-09-2015,199,PARTS,80,49,31,39%
06-04-2015,60704,VANGOGH14BDWBTX,58,71,-13,-22%
04-04-2015,62877,LOVELAND14BBTX,32,85,-53,-166%
29-12-2015,56160,MAGELLAN14CTO1,22,54,-32,-145%
02-05-2016,70524,PRGOLIADMLK123,25,27,-2,-8%
19-02-2015,199,PARTS,94,89,5,5%
19-10-2015,62882,LOVELAND14SCTO,70,63,7,10%
22-06-2017,53542,ALPINE 15,16,70,-54,-338%
10-10-2015,199,PARTS,31,46,-15,-48%
14-06-2017,53542,ALPINE 15,22,19,3,14%
17-07-2017,57514,HOUSTON12CTOE,70,68,2,3%
14-02-2017,60704,VANGOGH14BDWBTX,19,79,-60,-316%
20-05-2017,60150,TULIP15SKLBTX,69,73,-4,-6%
08-10-2017,63095,MERIDIANBTX,10,34,-24,-240%
17-08-2017,62904,BEAVERCREEK12BTX,80,95,-15,-19%
30-06-2016,62907,BEAVERCREEK14BTX,44,33,11,25%
22-02-2017,60704,VANGOGH14BDWBTX,78,8,70,90%
06-03-2016,57616,CRESTED BUTTEBTX,66,62,4,6%
12-09-2017,59515,BELMONTBTX,94,28,66,70%
24-10-2017,61339,MIRAMAR 15,31,87,-56,-181%
03-01-2016,57616,CRESTED BUTTEBTX,88,79,9,10%
20-08-2016,68338,ROUND ROCKMLKCTO,21,98,-77,-367%
23-07-2017,56746,MARBLE FALLS15BTX,24,4,20,83%
18-08-2016,62907,BEAVERCREEK14BTX,90,49,41,46%
21-07-2015,63886,PANDORA15SKLBTX,37,22,15,41%
27-12-2017,62851,PARKCITY12CTO,32,86,-54,-169%
24-03-2017,81747,PR53907COLUMXFR,43,3,40,93%
01-03-2017,62908,BEAVERCREEK14CTO,44,36,8,18%
21-05-2015,63886,PANDORA15SKLBTX,79,30,49,62%
09-03-2017,61173,JASBSW20BTX,68,39,29,43%
05-03-2015,60149,TULIP14SKLBTX,18,59,-41,-228%
04-11-2015,64250,JAYTONSECUREBTX,98,47,51,52%
19-11-2016,60150,TULIP15SKLBTX,23,89,-66,-287%
24-12-2017,61341,MIRAMAR 17,46,27,19,41%
18-01-2017,59384,IRIS15BDWBTX,95,59,36,38%
10-05-2016,56745,MARBLE FALLS15CTO,99,8,91,92%
22-10-2016,60150,TULIP15SKLBTX,31,14,17,55%
09-01-2015,59384,IRIS15BDWBTX,29,21,8,28%
05-09-2016,57616,CRESTED BUTTEBTX,22,75,-53,-241%
23-12-2017,62907,BEAVERCREEK14BTX,59,3,56,95%
05-07-2015,62907,BEAVERCREEK14BTX,82,92,-10,-12%
30-09-2016,60705,VANGOGH15BDWBTX,85,87,-2,-2%
03-03-2017,62856,PARKCITY15BTX,37,18,19,51%
22-07-2016,62907,BEAVERCREEK14BTX,57,24,33,58%
26-03-2015,57495,GOLIADMLK12CTOE,24,3,21,88%
06-04-2015,53775,LATITUDE OAK14,82,66,16,20%
18-12-2015,199,PARTS,13,34,-21,-162%
05-08-2017,62856,PARKCITY15BTX,27,99,-72,-267%
08-09-2017,199,PARTS,73,1,72,99%
21-05-2017,63886,PANDORA15SKLBTX,85,40,45,53%
07-04-2016,57515,HOUSTON12CTO,90,47,43,48%
08-03-2015,62907,BEAVERCREEK14BTX,93,85,8,9%
21-04-2017,62907,BEAVERCREEK14BTX,34,27,7,21%
18-07-2017,57616,CRESTED BUTTEBTX,68,46,22,32%
03-03-2016,57527,HOUSTON15CTO,98,62,36,37%
15-09-2017,62884,LOVELAND15SBTX,17,67,-50,-294%
03-05-2017,62884,LOVELAND15SBTX,53,25,28,53%
29-12-2015,62884,LOVELAND15SBTX,84,26,58,69%
17-06-2017,61341,MIRAMAR 17,97,8,89,92%
29-01-2015,62856,PARKCITY15BTX,68,86,-18,-26%
12-02-2015,59515,BELMONTBTX,10,76,-66,-660%
23-02-2015,199,PARTS,87,55,32,37%
12-01-2017,60704,VANGOGH14BDWBTX,2,95,-93,-4650%
03-12-2016,62856,PARKCITY15BTX,37,50,-13,-35%
13-12-2015,63276,MAPLE15SKLBTX,46,11,35,76%
16-05-2015,57368,FIGTREECTO,95,24,71,75%
10-03-2016,66803,SOMERSETBTX,59,77,-18,-31%
05-02-2017,199,PARTS,58,64,-6,-10%
04-05-2016,59384,IRIS15BDWBTX,18,39,-21,-117%
30-12-2016,199,PARTS,66,31,35,53%
08-07-2016,62884,LOVELAND15SBTX,86,8,78,91%
13-01-2015,62856,PARKCITY15BTX,85,66,19,22%
12-06-2015,59383,IRIS15BSWBTX,74,33,41,55%
10-03-2017,67623,MONET14SKLBTX,86,57,29,34%
06-10-2016,60704,VANGOGH14BDWBTX,9,32,-23,-256%
19-09-2016,60705,VANGOGH15BDWBTX,1,58,-57,-5700%
20-09-2015,62856,PARKCITY15BTX,89,34,55,62%
14-08-2016,60704,VANGOGH14BDWBTX,8,73,-65,-813%
18-07-2015,83940,PR55500ERIKSNATG,9,83,-74,-822%
20-02-2016,57499,GOLIADMLK14BTXE,48,40,8,17%
22-12-2016,62856,PARKCITY15BTX,45,1,44,98%
01-05-2016,62856,PARKCITY15BTX,22,38,-16,-73%
23-04-2016,62856,PARKCITY15BTX,96,11,85,89%
23-12-2017,57379,JEFFERSONBTX,3,33,-30,-1000%
03-04-2015,59379,IRIS14BSWBTX,20,87,-67,-335%
12-08-2015,59384,IRIS15BDWBTX,34,11,23,68%
09-10-2015,52357,SALADO15TAA1,64,2,62,97%
06-10-2016,62856,PARKCITY15BTX,97,78,19,20%
22-03-2015,60150,TULIP15SKLBTX,4,74,-70,-1750%
20-06-2015,53510,GOLIAD 12,36,21,15,42%
07-09-2016,62856,PARKCITY15BTX,97,3,94,97%
28-09-2017,60150,TULIP15SKLBTX,21,80,-59,-281%
17-10-2016,60705,VANGOGH15BDWBTX,49,77,-28,-57%
17-02-2015,62856,PARKCITY15BTX,82,71,11,13%
03-04-2015,63397,ECHO 15 MLK CTO,87,20,67,77%
26-11-2015,62853,PARKCITY14BTX,60,62,-2,-3%
19-11-2015,62856,PARKCITY15BTX,43,83,-40,-93%
11-08-2016,59383,IRIS15BSWBTX,71,11,60,85%
23-06-2016,61590,DINO2BTX,47,20,27,57%
30-03-2016,61590,DINO2BTX,58,81,-23,-40%
09-01-2017,62878,LOVELAND14BCTO,14,54,-40,-286%
09-11-2015,61590,DINO2BTX,72,87,-15,-21%
03-01-2015,199,PARTS,85,72,13,15%
18-12-2017,62856,PARKCITY15BTX,81,23,58,72%
13-10-2016,57455,TITAN14MLKBDWBTX,35,60,-25,-71%
22-12-2017,82589,PR54726MAGELLXFR,70,3,67,96%
21-12-2015,62856,PARKCITY15BTX,46,68,-22,-48%
01-03-2015,60151,TULIP17SKLBTX,34,53,-19,-56%
02-02-2016,76961,PR51086LIVNGSTON,67,88,-21,-31%
26-05-2017,57455,TITAN14MLKBDWBTX,22,48,-26,-118%
13-05-2016,61590,DINO2BTX,79,52,27,34%
01-05-2016,61590,DINO2BTX,14,66,-52,-371%
08-09-2017,61590,DINO2BTX,58,86,-28,-48%
15-11-2015,60705,VANGOGH15BDWBTX,44,97,-53,-120%
21-11-2017,63039,PARKCITY-P15CTO,15,55,-40,-267%
25-09-2015,59384,IRIS15BDWBTX,79,38,41,52%
01-07-2016,60705,VANGOGH15BDWBTX,100,26,74,74%
29-01-2016,60705,VANGOGH15BDWBTX,84,33,51,61%
28-08-2015,61590,DINO2BTX,45,10,35,78%
08-12-2016,60151,TULIP17SKLBTX,80,44,36,45%
10-02-2017,61590,DINO2BTX,26,94,-68,-262%
11-02-2016,199,PARTS,61,66,-5,-8%
08-12-2016,36029,SLINKY,18,2,16,89%
15-10-2015,62907,BEAVERCREEK14BTX,47,61,-14,-30%
12-02-2017,36029,SLINKY,53,42,11,21%
10-12-2016,60704,VANGOGH14BDWBTX,43,93,-50,-116%
27-04-2017,57368,FIGTREECTO,4,35,-31,-775%
01-10-2016,61590,DINO2BTX,22,15,7,32%
10-08-2017,61590,DINO2BTX,33,36,-3,-9%
05-05-2017,55725,CEDAR15HSWBTX,68,49,19,28%
13-07-2017,61590,DINO2BTX,99,34,65,66%
15-12-2017,61590,DINO2BTX,99,80,19,19%
12-10-2016,60151,TULIP17SKLBTX,6,75,-69,-1150%
20-11-2016,62856,PARKCITY15BTX,24,94,-70,-292%
10-12-2015,83232,PR35512BOLDPEAK2,56,38,18,32%
24-11-2016,62880,LOVELAND15SCTO,79,66,13,16%
04-02-2016,60704,VANGOGH14BDWBTX,70,55,15,21%
23-02-2016,72499,PR48635PLANOB,35,81,-46,-131%
14-04-2015,53775,LATITUDE OAK14,56,32,24,43%
06-10-2017,69930,CELTICCTO1,34,11,23,68%
29-01-2015,62907,BEAVERCREEK14BTX,41,29,12,29%
22-12-2016,199,PARTS,86,83,3,3%
07-01-2016,61239,REDWOODMLKBSWBTX,89,12,77,87%
24-03-2017,61590,DINO2BTX,11,71,-60,-545%
15-02-2017,61341,MIRAMAR 17,89,51,38,43%
09-11-2015,60812,VENENOBTX,20,39,-19,-95%
01-07-2017,81902,PR41349GOLI12MLK,46,29,17,37%
29-06-2017,473,NON_TIED_PERIPHERALS,74,16,58,78%
04-09-2017,57190,ERIKSSON14BTX,40,37,3,8%
29-02-2016,62853,PARKCITY14BTX,56,29,27,48%
13-05-2017,62853,PARKCITY14BTX,50,3,47,94%
10-07-2017,62853,PARKCITY14BTX,73,97,-24,-33%
03-12-2017,61590,DINO2BTX,94,99,-5,-5%
22-09-2015,62856,PARKCITY15BTX,47,23,24,51%
15-04-2015,53852,DIESEL17CTO,44,24,20,45%
30-12-2017,62877,LOVELAND14BBTX,42,54,-12,-29%
12-05-2017,199,PARTS,37,66,-29,-78%
31-01-2016,62854,PARKCITY14CTO,20,76,-56,-280%
31-10-2017,60704,VANGOGH14BDWBTX,26,81,-55,-212%
23-10-2017,56151,MAGELLAN14CTO,46,76,-30,-65%
04-11-2017,62856,PARKCITY15BTX,28,25,3,11%
28-11-2017,60812,VENENOBTX,68,42,26,38%
15-05-2015,68337,ROUND ROCKMLKBTX,1,18,-17,-1700%
18-04-2017,73513,PR49409GOL14MLKA,18,32,-14,-78%
27-11-2015,61339,MIRAMAR 15,62,79,-17,-27%
19-04-2015,59515,BELMONTBTX,54,75,-21,-39%
19-12-2016,71168,PR47566GOL14MLKO,25,38,-13,-52%
02-06-2017,199,PARTS,58,5,53,91%
07-11-2015,60153,TULIP15AMDBTX,95,89,6,6%
05-12-2015,60151,TULIP17SKLBTX,11,90,-79,-718%
21-12-2017,60705,VANGOGH15BDWBTX,34,76,-42,-124%
03-03-2017,60149,TULIP14SKLBTX,88,60,28,32%
17-08-2016,199,PARTS,15,21,-6,-40%
31-08-2016,199,PARTS,34,54,-20,-59%
07-06-2016,60151,TULIP17SKLBTX,46,16,30,65%
13-04-2016,80397,PR53148GO14MLKAE,49,42,7,14%
16-08-2017,80582,PR46496GOLI12MLK,14,48,-34,-243%
04-06-2016,62884,LOVELAND15SBTX,65,97,-32,-49%
02-11-2017,60147,TULIP15BDWBTX,90,70,20,22%
26-07-2015,62857,PARKCITY15CTO,96,50,46,48%
16-04-2015,54983,ROUND ROCK,48,25,23,48%
23-07-2017,60813,BERLINETTABTX,9,61,-52,-578%
06-04-2016,60705,VANGOGH15BDWBTX,92,73,19,21%
30-08-2016,56746,MARBLE FALLS15BTX,83,52,31,37%
31-12-2015,62856,PARKCITY15BTX,47,77,-30,-64%
22-04-2016,55757,MAPLEM14BDWBTX,4,2,2,50%
24-11-2016,60151,TULIP17SKLBTX,95,95,0,0%
17-12-2015,199,PARTS,67,41,26,39%
12-09-2015,61341,MIRAMAR 17,96,92,4,4%
06-11-2017,62850,PARKCITY12BTX,27,55,-28,-104%
17-01-2016,60151,TULIP17SKLBTX,3,29,-26,-867%
23-03-2015,60813,BERLINETTABTX,66,86,-20,-30%
06-07-2016,78657,PR52034GOL14MLKA,80,26,54,68%
15-04-2017,53512,GOLIAD 14,83,71,12,14%
19-01-2015,62875,PARKCITY15CTO1,92,72,20,22%
10-12-2016,65308,BLACKWELLT4BTX,18,60,-42,-233%
25-09-2017,60151,TULIP17SKLBTX,67,2,65,97%
29-09-2016,59384,IRIS15BDWBTX,23,58,-35,-152%
24-05-2015,62856,PARKCITY15BTX,11,9,2,18%
07-03-2015,199,PARTS,56,45,11,20%
26-12-2016,60707,VANGOGH15SKLBTX,91,10,81,89%
30-07-2017,199,PARTS,58,72,-14,-24%
22-05-2016,62872,PARKCITY14CTO1,93,15,78,84%
14-03-2017,59383,IRIS15BSWBTX,28,55,-27,-96%
17-09-2016,69925,CELTICCTO,28,15,13,46%
08-02-2016,79963,PR52610JAYTON,36,35,1,3%
01-04-2015,62877,LOVELAND14BBTX,26,75,-49,-188%
13-10-2017,81758,PR53944HOUSTN14O,50,100,-50,-100%
16-09-2016,62883,LOVELAND15BCTO,56,28,28,50%
20-08-2015,60147,TULIP15BDWBTX,95,35,60,63%
17-06-2017,60147,TULIP15BDWBTX,86,44,42,49%
14-04-2017,68337,ROUND ROCKMLKBTX,64,24,40,63%
27-08-2017,61590,DINO2BTX,61,84,-23,-38%
05-01-2015,60147,TULIP15BDWBTX,1,80,-79,-7900%
28-12-2017,68338,ROUND ROCKMLKCTO,31,14,17,55%
01-01-2016,55757,MAPLEM14BDWBTX,82,50,32,39%
21-01-2016,60813,BERLINETTABTX,31,35,-4,-13%
10-03-2017,75366,PR50404HOUSTN14O,91,57,34,37%
06-03-2015,60812,VENENOBTX,51,100,-49,-96%
19-01-2017,60147,TULIP15BDWBTX,47,64,-17,-36%
14-10-2016,60147,TULIP15BDWBTX,46,97,-51,-111%
28-04-2015,82260,PR54294HOUSTN14O,33,76,-43,-130%
30-05-2016,59383,IRIS15BSWBTX,61,1,60,98%
08-12-2017,62856,PARKCITY15BTX,82,2,80,98%
14-10-2015,62856,PARKCITY15BTX,80,33,47,59%
28-03-2016,52332,SALADO14BTX,54,28,26,48%
18-04-2015,60147,TULIP15BDWBTX,15,12,3,20%
21-09-2015,62854,PARKCITY14CTO,37,19,18,49%
12-06-2015,56743,MARBLE FALLS14CTO,52,67,-15,-29%
18-10-2015,32575,BRUTUS,3,39,-36,-1200%
17-09-2016,59384,IRIS15BDWBTX,8,42,-34,-425%
27-07-2015,56745,MARBLE FALLS15CTO,73,17,56,77%
10-12-2016,62857,PARKCITY15CTO,15,97,-82,-547%
16-07-2017,199,PARTS,95,42,53,56%
21-11-2016,61334,BERLINETTA PBTX,77,36,41,53%
24-08-2015,199,PARTS,83,7,76,92%
12-08-2015,79987,PR53050PRKCTY15O,83,27,56,67%
12-06-2016,77469,PR32534CRESBUTTE,95,50,45,47%
30-05-2017,62856,PARKCITY15BTX,44,7,37,84%
19-11-2016,55728,CEDAR15BDWBTX,60,8,52,87%
26-01-2017,52332,SALADO14BTX,30,19,11,37%
21-12-2015,52332,SALADO14BTX,65,100,-35,-54%
16-08-2015,62892,LOVELAND15FBCTO,73,92,-19,-26%
04-08-2017,60705,VANGOGH15BDWBTX,76,40,36,47%
19-01-2016,62856,PARKCITY15BTX,43,43,0,0%
12-03-2017,67623,MONET14SKLBTX,2,96,-94,-4700%
05-08-2017,60705,VANGOGH15BDWBTX,7,84,-77,-1100%
31-01-2017,199,PARTS,52,17,35,67%
23-01-2017,56158,COLUMBUS12TAA1,66,28,38,58%
18-10-2016,83507,PR55182ERIKSNATG,2,47,-45,-2250%
17-02-2017,60705,VANGOGH15BDWBTX,49,44,5,10%
08-02-2015,52333,SALADO15BTX,31,38,-7,-23%
15-07-2015,199,PARTS,25,30,-5,-20%
13-02-2016,62856,PARKCITY15BTX,96,29,67,70%
18-01-2016,66803,SOMERSETBTX,42,91,-49,-117%
28-12-2017,54983,ROUND ROCK,67,82,-15,-22%
25-08-2015,199,PARTS,75,59,16,21%
22-07-2016,60704,VANGOGH14BDWBTX,17,16,1,6%
08-03-2016,61334,BERLINETTA PBTX,4,75,-71,-1775%
03-07-2016,199,PARTS,49,47,2,4%
27-09-2016,57514,HOUSTON12CTOE,77,62,15,19%
24-09-2017,75889,PR50761COLUMXFR,70,70,0,0%
02-12-2017,63886,PANDORA15SKLBTX,63,33,30,48%
12-05-2015,82695,PR41691LOVELNS15,46,4,42,91%
09-12-2016,60151,TULIP17SKLBTX,88,9,79,90%
30-11-2016,63039,PARKCITY-P15CTO,33,27,6,18%
25-09-2015,62850,PARKCITY12BTX,22,36,-14,-64%
17-09-2017,59860,SILVERTONBTX,18,23,-5,-28%
10-11-2016,199,PARTS,34,35,-1,-3%
06-08-2017,76548,PR32116PLANOM,62,3,59,95%
05-11-2016,59379,IRIS14BSWBTX,89,58,31,35%
23-03-2015,56744,MARBLE FALLS14BTX,6,23,-17,-283%
02-07-2017,83045,PR55032DIESEL17,94,48,46,49%
21-01-2015,36028,SKIPPER,60,72,-12,-20%
21-05-2016,59794,EAGLEPEAKBTX,20,46,-26,-130%
01-05-2015,63095,MERIDIANBTX,93,86,7,8%
22-11-2016,76958,PR51156HOUSTN14O,44,20,24,55%
05-02-2016,60813,BERLINETTABTX,73,93,-20,-27%
13-05-2015,62856,PARKCITY15BTX,71,26,45,63%
04-02-2015,52371,SALADO 15,91,70,21,23%
12-07-2015,56744,MARBLE FALLS14BTX,30,55,-25,-83%
28-02-2017,63039,PARKCITY-P15CTO,65,85,-20,-31%
16-07-2015,59379,IRIS14BSWBTX,18,91,-73,-406%
30-11-2017,81758,PR53944HOUSTN14O,73,39,34,47%
18-04-2015,63253,REDWOODSKLBTX,17,84,-67,-394%
31-01-2015,57624,CRESTEDBUTTETAA1,35,70,-35,-100%
12-10-2015,61239,REDWOODMLKBSWBTX,38,64,-26,-68%
18-02-2016,63886,PANDORA15SKLBTX,97,5,92,95%
15-07-2015,63397,ECHO 15 MLK CTO,17,8,9,53%
17-03-2015,60828,BOLDPEAK2CTO1,3,75,-72,-2400%
07-03-2016,61949,LIVINGSTONECTO,43,87,-44,-102%
07-12-2015,57494,GOLIADMLK12BTXE,59,99,-40,-68%
22-06-2015,62856,PARKCITY15BTX,71,7,64,90%
01-02-2015,199,PARTS,57,34,23,40%
07-11-2016,57514,HOUSTON12CTOE,6,1,5,83%
02-03-2015,73118,PR49144ERIKSNATG,57,25,32,56%
25-08-2017,199,PARTS,70,88,-18,-26%
09-11-2015,52371,SALADO 15,93,51,42,45%
05-10-2016,57514,HOUSTON12CTOE,10,35,-25,-250%
23-01-2016,199,PARTS,55,78,-23,-42%
28-06-2016,60813,BERLINETTABTX,12,90,-78,-650%
11-05-2015,60705,VANGOGH15BDWBTX,4,45,-41,-1025%
10-05-2015,74472,PR49909CRESBUTEA,27,24,3,11%
05-02-2017,56517,REDWOODBTX,47,83,-36,-77%
11-06-2015,62905,BEAVERCREEK12CTO,98,50,48,49%
18-03-2017,59384,IRIS15BDWBTX,85,46,39,46%
22-05-2017,57514,HOUSTON12CTOE,22,90,-68,-309%
08-02-2016,59383,IRIS15BSWBTX,53,32,21,40%
01-04-2016,52371,SALADO 15,14,55,-41,-293%
12-10-2016,60813,BERLINETTABTX,72,96,-24,-33%
17-02-2016,52375,SALADO 14 CTO,69,33,36,52%
11-06-2016,57497,GOLIADMLK14CTOE,79,66,13,16%
01-12-2016,59379,IRIS14BSWBTX,89,48,41,46%
10-07-2017,53291,DIESEL 15,100,76,24,24%
15-04-2015,60146,TULIP14BDWBTX,71,66,5,7%
20-02-2017,56743,MARBLE FALLS14CTO,21,3,18,86%
06-02-2016,62905,BEAVERCREEK12CTO,43,6,37,86%
05-10-2016,199,PARTS,46,31,15,33%
23-10-2016,70901,ROCKET11BSWBTX,68,96,-28,-41%
13-11-2016,70901,ROCKET11BSWBTX,10,13,-3,-30%
16-09-2016,57513,HOUSTON12BTX,45,8,37,82%
12-11-2017,62850,PARKCITY12BTX,61,85,-24,-39%
16-02-2017,199,PARTS,20,62,-42,-210%
17-01-2016,77472,PR32591HOUSTN12E,7,15,-8,-114%
05-02-2016,62857,PARKCITY15CTO,70,52,18,26%
07-05-2015,60705,VANGOGH15BDWBTX,61,96,-35,-57%
29-03-2015,64248,JAYTONBTX,19,33,-14,-74%
21-04-2017,62883,LOVELAND15BCTO,2,13,-11,-550%
29-05-2016,60151,TULIP17SKLBTX,60,1,59,98%
28-01-2015,56744,MARBLE FALLS14BTX,37,97,-60,-162%
09-08-2017,60705,VANGOGH15BDWBTX,41,26,15,37%
29-04-2015,56151,MAGELLAN14CTO,7,34,-27,-386%
11-02-2017,62856,PARKCITY15BTX,83,4,79,95%
04-11-2016,62853,PARKCITY14BTX,72,40,32,44%
01-02-2015,57631,MAPLE15AMDBTX,58,81,-23,-40%
10-01-2015,59379,IRIS14BSWBTX,76,43,33,43%
22-07-2016,57631,MAPLE15AMDBTX,37,82,-45,-122%
03-01-2016,62853,PARKCITY14BTX,25,15,10,40%
27-10-2017,60705,VANGOGH15BDWBTX,89,40,49,55%
26-05-2016,57494,GOLIADMLK12BTXE,54,60,-6,-11%
25-09-2015,62853,PARKCITY14BTX,90,12,78,87%
01-05-2016,62853,PARKCITY14BTX,56,82,-26,-46%
09-04-2015,62853,PARKCITY14BTX,11,66,-55,-500%
31-10-2015,61590,DINO2BTX,64,22,42,66%
10-03-2015,80368,PR53285PKCTYP15O,1,58,-57,-5700%
06-08-2015,199,PARTS,48,5,43,90%
26-05-2017,62853,PARKCITY14BTX,70,63,7,10%
22-01-2015,63886,PANDORA15SKLBTX,73,9,64,88%
26-02-2016,57519,HOUSTON14BTX,26,36,-10,-38%
11-06-2017,62889,LOVELAND15FBBTX,41,59,-18,-44%
01-04-2016,56153,COLUMBUS12CTO,58,43,15,26%
14-01-2017,59379,IRIS14BSWBTX,4,43,-39,-975%
17-07-2015,60705,VANGOGH15BDWBTX,31,95,-64,-206%
21-07-2015,56153,COLUMBUS12CTO,29,12,17,59%
23-07-2015,62908,BEAVERCREEK14CTO,23,63,-40,-174%
11-08-2016,62856,PARKCITY15BTX,28,61,-33,-118%
07-03-2016,62892,LOVELAND15FBCTO,6,86,-80,-1333%
22-03-2015,60148,TULIP17BDWBTX,25,94,-69,-276%
12-06-2017,63095,MERIDIANBTX,35,15,20,57%
15-04-2017,68338,ROUND ROCKMLKCTO,12,6,6,50%
16-06-2016,62851,PARKCITY12CTO,83,95,-12,-14%
14-02-2015,62850,PARKCITY12BTX,19,14,5,26%
11-05-2016,57519,HOUSTON14BTX,15,3,12,80%
23-10-2017,83970,PR55549PRKCTY14O,24,97,-73,-304%
23-09-2017,62881,LOVELAND14SBTX,54,63,-9,-17%
22-02-2017,60146,TULIP14BDWBTX,58,54,4,7%
06-08-2015,60705,VANGOGH15BDWBTX,95,32,63,66%
02-09-2016,61949,LIVINGSTONECTO,43,87,-44,-102%
15-01-2017,57513,HOUSTON12BTX,7,26,-19,-271%
30-01-2017,57494,GOLIADMLK12BTXE,100,76,24,24%
01-05-2016,56151,MAGELLAN14CTO,75,62,13,17%
25-12-2015,57494,GOLIADMLK12BTXE,95,28,67,71%
11-12-2017,56151,MAGELLAN14CTO,77,99,-22,-29%
14-11-2017,62856,PARKCITY15BTX,100,20,80,80%
03-03-2015,52371,SALADO 15,77,50,27,35%
20-10-2017,57515,HOUSTON12CTO,95,68,27,28%
12-03-2017,57494,GOLIADMLK12BTXE,14,27,-13,-93%
07-12-2017,57494,GOLIADMLK12BTXE,88,7,81,92%
06-01-2017,59860,SILVERTONBTX,44,51,-7,-16%
30-09-2016,59860,SILVERTONBTX,24,25,-1,-4%
03-02-2015,57494,GOLIADMLK12BTXE,50,52,-2,-4%
05-06-2017,57637,FOXGLOVEBTX,83,37,46,55%
22-08-2015,57305,HADLEY17BDWBTX,95,21,74,78%
28-04-2015,60813,BERLINETTABTX,30,98,-68,-227%
15-06-2015,59515,BELMONTBTX,6,68,-62,-1033%
17-09-2015,69925,CELTICCTO,98,64,34,35%
19-03-2017,60147,TULIP15BDWBTX,85,74,11,13%
07-08-2017,62904,BEAVERCREEK12BTX,44,25,19,43%
21-07-2016,59381,IRIS14SKLBTX,39,95,-56,-144%
12-06-2017,60153,TULIP15AMDBTX,57,58,-1,-2%
22-10-2016,80764,PR53609GO14MLKOE,57,61,-4,-7%
25-03-2015,62881,LOVELAND14SBTX,31,20,11,35%
14-12-2017,60822,BOLDPEAK2BTX,14,52,-38,-271%
04-09-2017,62857,PARKCITY15CTO,13,17,-4,-31%
03-06-2016,60153,TULIP15AMDBTX,22,25,-3,-14%
29-06-2017,73929,DRAXBTX,51,90,-39,-76%
26-03-2015,60705,VANGOGH15BDWBTX,93,12,81,87%
29-03-2017,67623,MONET14SKLBTX,1,5,-4,-400%
29-11-2015,199,PARTS,90,61,29,32%
14-11-2017,61239,REDWOODMLKBSWBTX,56,15,41,73%
01-09-2017,199,PARTS,76,82,-6,-8%
07-10-2016,63254,REDWOODBSKLBTX,48,13,35,73%
20-02-2015,63251,BLACKWOODSKLBTX,81,100,-19,-23%
25-12-2017,60705,VANGOGH15BDWBTX,23,21,2,9%
10-05-2016,62905,BEAVERCREEK12CTO,52,90,-38,-73%
08-10-2016,60153,TULIP15AMDBTX,13,13,0,0%
18-09-2016,60822,BOLDPEAK2BTX,13,64,-51,-392%
24-06-2015,60705,VANGOGH15BDWBTX,61,85,-24,-39%
08-01-2015,62881,LOVELAND14SBTX,69,36,33,48%
21-03-2015,60153,TULIP15AMDBTX,48,45,3,6%
15-01-2015,57191,ERIKSSON14CTO,73,48,25,34%
06-05-2016,70901,ROCKET11BSWBTX,3,67,-64,-2133%
03-08-2015,199,PARTS,49,21,28,57%
20-04-2016,60704,VANGOGH14BDWBTX,84,15,69,82%
05-01-2016,64248,JAYTONBTX,31,63,-32,-103%
03-03-2015,59383,IRIS15BSWBTX,52,19,33,63%
18-04-2017,59379,IRIS14BSWBTX,45,92,-47,-104%
25-12-2017,59383,IRIS15BSWBTX,87,69,18,21%
17-03-2015,60148,TULIP17BDWBTX,78,61,17,22%
15-02-2016,54983,ROUND ROCK,99,60,39,39%
07-03-2016,61333,BERLINETTA P,69,34,35,51%
27-11-2017,57496,GOLIADMLK12TAAE,48,95,-47,-98%
23-08-2016,57496,GOLIADMLK12TAAE,53,98,-45,-85%
27-05-2017,63394,ECHO 13 MLK BTX,27,53,-26,-96%
14-06-2015,199,PARTS,96,43,53,55%
30-01-2017,54142,TESTAROSSA P,30,11,19,63%
31-03-2017,79965,PR52997SILVERTON,84,44,40,48%
24-03-2016,63396,ECHO 15 MLK BTX,39,19,20,51%
14-07-2015,54983,ROUND ROCK,61,96,-35,-57%
04-08-2015,57521,HOUSTON14CTO,86,29,57,66%
06-12-2015,57513,HOUSTON12BTX,25,66,-41,-164%
23-12-2015,70901,ROCKET11BSWBTX,63,52,11,17%
27-04-2017,60153,TULIP15AMDBTX,17,4,13,76%
23-08-2015,59379,IRIS14BSWBTX,83,62,21,25%
23-03-2016,62884,LOVELAND15SBTX,71,40,31,44%
13-03-2017,60707,VANGOGH15SKLBTX,82,92,-10,-12%
12-01-2017,63095,MERIDIANBTX,24,55,-31,-129%
30-03-2017,60146,TULIP14BDWBTX,57,51,6,11%
07-05-2016,62884,LOVELAND15SBTX,63,15,48,76%
01-05-2016,59379,IRIS14BSWBTX,93,53,40,43%
29-08-2015,63396,ECHO 15 MLK BTX,25,76,-51,-204%
10-08-2015,70901,ROCKET11BSWBTX,30,94,-64,-213%
27-11-2015,70901,ROCKET11BSWBTX,58,99,-41,-71%
29-05-2015,473,NON_TIED_PERIPHERALS,99,13,86,87%
12-10-2017,60151,TULIP17SKLBTX,21,60,-39,-186%
07-09-2015,61239,REDWOODMLKBSWBTX,23,83,-60,-261%
06-02-2015,62857,PARKCITY15CTO,1,52,-51,-5100%
24-12-2015,199,PARTS,30,36,-6,-20%
19-10-2016,67623,MONET14SKLBTX,18,20,-2,-11%
03-06-2016,54142,TESTAROSSA P,70,67,3,4%
27-03-2015,57191,ERIKSSON14CTO,19,38,-19,-100%
01-09-2015,62911,BEAVERCREEK12FCTO,43,36,7,16%
24-12-2016,199,PARTS,85,29,56,66%
18-03-2015,60707,VANGOGH15SKLBTX,91,62,29,32%
26-11-2015,60707,VANGOGH15SKLBTX,72,48,24,33%
25-10-2015,60150,TULIP15SKLBTX,76,67,9,12%
30-09-2015,66803,SOMERSETBTX,48,23,25,52%
01-08-2016,54142,TESTAROSSA P,23,36,-13,-57%
02-03-2017,60153,TULIP15AMDBTX,29,42,-13,-45%
05-07-2015,68337,ROUND ROCKMLKBTX,33,74,-41,-124%
03-11-2015,60147,TULIP15BDWBTX,95,92,3,3%
07-08-2017,68337,ROUND ROCKMLKBTX,73,45,28,38%
17-07-2016,199,PARTS,73,50,23,32%
20-05-2016,63039,PARKCITY-P15CTO,7,8,-1,-14%
05-09-2016,63886,PANDORA15SKLBTX,59,77,-18,-31%
02-08-2017,63886,PANDORA15SKLBTX,94,19,75,80%
25-06-2016,199,PARTS,26,95,-69,-265%
10-09-2015,62907,BEAVERCREEK14BTX,11,76,-65,-591%
05-02-2015,60151,TULIP17SKLBTX,25,18,7,28%
09-02-2015,60150,TULIP15SKLBTX,61,98,-37,-61%
08-12-2017,60153,TULIP15AMDBTX,93,14,79,85%
12-01-2015,199,PARTS,8,48,-40,-500%
28-09-2015,57368,FIGTREECTO,18,68,-50,-278%
30-09-2017,71647,PR48058GOL14MLKA,27,13,14,52%
14-02-2017,199,PARTS,88,84,4,5%
22-10-2017,60153,TULIP15AMDBTX,65,85,-20,-31%
05-04-2017,62856,PARKCITY15BTX,35,53,-18,-51%
10-11-2017,199,PARTS,68,26,42,62%
11-01-2015,62853,PARKCITY14BTX,95,54,41,43%
19-11-2017,80773,PR53407JAYTON,70,12,58,83%
11-11-2017,199,PARTS,74,74,0,0%
14-11-2015,54983,ROUND ROCK,100,63,37,37%
05-11-2015,62856,PARKCITY15BTX,42,30,12,29%
19-10-2016,57617,CRESTED BUTTECTO,17,69,-52,-306%
24-05-2016,62853,PARKCITY14BTX,8,65,-57,-713%
19-04-2017,60707,VANGOGH15SKLBTX,39,39,0,0%
23-04-2016,56746,MARBLE FALLS15BTX,15,82,-67,-447%
13-12-2017,60813,BERLINETTABTX,76,35,41,54%
09-07-2015,63396,ECHO 15 MLK BTX,36,8,28,78%
30-07-2015,63396,ECHO 15 MLK BTX,92,68,24,26%
28-07-2016,63396,ECHO 15 MLK BTX,19,31,-12,-63%
14-10-2017,63396,ECHO 15 MLK BTX,76,93,-17,-22%
12-11-2015,49918,OAKM17IVBBTX,58,8,50,86%
09-04-2017,199,PARTS,24,58,-34,-142%
28-02-2017,62907,BEAVERCREEK14BTX,54,22,32,59%
12-02-2017,60150,TULIP15SKLBTX,54,55,-1,-2%
24-10-2015,59515,BELMONTBTX,15,49,-34,-227%
28-04-2016,60148,TULIP17BDWBTX,39,5,34,87%
28-12-2016,60707,VANGOGH15SKLBTX,5,26,-21,-420%
08-01-2016,57514,HOUSTON12CTOE,34,17,17,50%
22-02-2015,62879,LOVELAND15BBTX,44,21,23,52%
14-11-2015,59515,BELMONTBTX,80,56,24,30%
12-04-2015,62877,LOVELAND14BBTX,20,84,-64,-320%
25-06-2015,60153,TULIP15AMDBTX,31,70,-39,-126%
03-09-2017,68337,ROUND ROCKMLKBTX,60,68,-8,-13%
15-01-2015,68337,ROUND ROCKMLKBTX,32,72,-40,-125%
18-02-2016,59383,IRIS15BSWBTX,13,44,-31,-238%
29-05-2017,80775,PR53429SILVERTON,72,11,61,85%
27-11-2015,63886,PANDORA15SKLBTX,99,51,48,48%
14-07-2015,60148,TULIP17BDWBTX,12,79,-67,-558%
23-02-2016,56746,MARBLE FALLS15BTX,17,36,-19,-112%
31-12-2016,56746,MARBLE FALLS15BTX,84,5,79,94%
29-05-2015,56746,MARBLE FALLS15BTX,98,93,5,5%
03-03-2017,68338,ROUND ROCKMLKCTO,35,20,15,43%
27-11-2015,64248,JAYTONBTX,52,25,27,52%
15-02-2015,61590,DINO2BTX,93,84,9,10%
08-04-2017,69923,CELTICBTX,21,79,-58,-276%
16-10-2015,60153,TULIP15AMDBTX,78,76,2,3%
31-10-2016,38851,SQUEEZE,78,81,-3,-4%
06-05-2017,57514,HOUSTON12CTOE,19,23,-4,-21%
23-06-2017,63886,PANDORA15SKLBTX,17,61,-44,-259%
15-01-2015,63394,ECHO 13 MLK BTX,38,27,11,29%
22-12-2017,85179,PR56226ERIKSNATG,66,84,-18,-27%
28-03-2015,199,PARTS,6,35,-29,-483%
03-05-2015,60151,TULIP17SKLBTX,72,87,-15,-21%
12-10-2015,60153,TULIP15AMDBTX,81,62,19,23%
17-07-2016,60153,TULIP15AMDBTX,61,67,-6,-10%
02-11-2016,60150,TULIP15SKLBTX,76,56,20,26%
19-03-2015,60148,TULIP17BDWBTX,14,38,-24,-171%
08-07-2016,60151,TULIP17SKLBTX,86,82,4,5%
30-12-2015,62884,LOVELAND15SBTX,59,90,-31,-53%
06-06-2015,57499,GOLIADMLK14BTXE,2,59,-57,-2850%
02-03-2015,60150,TULIP15SKLBTX,92,29,63,68%
13-11-2015,62877,LOVELAND14BBTX,75,61,14,19%
16-02-2015,62905,BEAVERCREEK12CTO,28,4,24,86%
19-01-2017,199,PARTS,42,46,-4,-10%
06-06-2017,62877,LOVELAND14BBTX,66,11,55,83%
16-11-2016,60151,TULIP17SKLBTX,70,60,10,14%
29-07-2016,62881,LOVELAND14SBTX,66,67,-1,-2%
12-11-2017,57525,HOUSTON15BTX,15,24,-9,-60%
12-03-2015,60813,BERLINETTABTX,53,71,-18,-34%
09-04-2017,60150,TULIP15SKLBTX,40,55,-15,-38%
30-11-2016,56746,MARBLE FALLS15BTX,91,39,52,57%
08-02-2016,57521,HOUSTON14CTO,95,19,76,80%
01-05-2016,62854,PARKCITY14CTO,21,99,-78,-371%
15-03-2015,60707,VANGOGH15SKLBTX,31,96,-65,-210%
06-07-2015,57616,CRESTED BUTTEBTX,80,93,-13,-16%
27-04-2016,57616,CRESTED BUTTEBTX,49,61,-12,-24%
06-11-2017,57616,CRESTED BUTTEBTX,76,36,40,53%
23-01-2016,53291,DIESEL 15,42,22,20,48%
15-04-2017,57616,CRESTED BUTTEBTX,59,78,-19,-32%
31-03-2015,76953,PR51154GOL14MLKO,92,78,14,15%
21-05-2015,60147,TULIP15BDWBTX,90,81,9,10%
18-11-2015,60822,BOLDPEAK2BTX,14,46,-32,-229%
09-08-2017,62882,LOVELAND14SCTO,68,53,15,22%
19-02-2016,62884,LOVELAND15SBTX,39,57,-18,-46%
08-03-2016,56157,COLUMBUS12CTO1,31,52,-21,-68%
22-07-2015,199,PARTS,37,36,1,3%
31-01-2017,57513,HOUSTON12BTX,79,11,68,86%
12-06-2015,53779,LATITUDE OAK15,96,89,7,7%
20-03-2016,57616,CRESTED BUTTEBTX,14,12,2,14%
20-07-2015,56746,MARBLE FALLS15BTX,40,87,-47,-118%
07-01-2017,56746,MARBLE FALLS15BTX,89,5,84,94%
12-02-2016,56743,MARBLE FALLS14CTO,38,98,-60,-158%
28-02-2017,62904,BEAVERCREEK12BTX,66,12,54,82%
13-11-2017,60150,TULIP15SKLBTX,61,40,21,34%
15-03-2016,60153,TULIP15AMDBTX,66,87,-21,-32%
23-09-2017,60147,TULIP15BDWBTX,95,33,62,65%
21-02-2015,57497,GOLIADMLK14CTOE,3,99,-96,-3200%
08-09-2016,62904,BEAVERCREEK12BTX,74,2,72,97%
02-09-2017,60812,VENENOBTX,1,80,-79,-7900%
26-12-2017,59383,IRIS15BSWBTX,17,10,7,41%
07-11-2015,199,PARTS,23,74,-51,-222%
08-03-2016,57521,HOUSTON14CTO,82,3,79,96%
03-05-2017,62908,BEAVERCREEK14CTO,73,50,23,32%
06-07-2016,60153,TULIP15AMDBTX,89,45,44,49%
01-02-2015,62904,BEAVERCREEK12BTX,7,26,-19,-271%
22-09-2016,60147,TULIP15BDWBTX,49,69,-20,-41%
11-05-2015,53291,DIESEL 15,17,84,-67,-394%
12-06-2016,56746,MARBLE FALLS15BTX,34,60,-26,-76%
01-05-2017,59794,EAGLEPEAKBTX,100,54,46,46%
25-12-2016,62857,PARKCITY15CTO,83,47,36,43%
06-02-2016,62905,BEAVERCREEK12CTO,8,71,-63,-788%
03-10-2015,199,PARTS,83,78,5,6%
17-03-2017,56746,MARBLE FALLS15BTX,43,64,-21,-49%
03-06-2016,59383,IRIS15BSWBTX,42,21,21,50%
19-05-2015,64250,JAYTONSECUREBTX,50,63,-13,-26%
15-04-2016,63394,ECHO 13 MLK BTX,35,29,6,17%
28-02-2017,56744,MARBLE FALLS14BTX,46,19,27,59%
07-03-2016,64250,JAYTONSECUREBTX,3,57,-54,-1800%
14-10-2017,61341,MIRAMAR 17,37,40,-3,-8%
24-07-2015,53291,DIESEL 15,65,88,-23,-35%
21-09-2016,60150,TULIP15SKLBTX,39,30,9,23%
30-07-2017,53850,DIESEL15CTO,4,64,-60,-1500%
30-11-2017,62883,LOVELAND15BCTO,24,86,-62,-258%
28-12-2017,60150,TULIP15SKLBTX,50,10,40,80%
12-11-2016,62904,BEAVERCREEK12BTX,42,42,0,0%
28-11-2015,60150,TULIP15SKLBTX,25,80,-55,-220%
03-05-2016,62882,LOVELAND14SCTO,76,78,-2,-3%
30-03-2015,56160,MAGELLAN14CTO1,35,95,-60,-171%
19-03-2017,64250,JAYTONSECUREBTX,28,94,-66,-236%
02-08-2015,64250,JAYTONSECUREBTX,28,25,3,11%
04-01-2015,64250,JAYTONSECUREBTX,86,79,7,8%
03-03-2015,62880,LOVELAND15SCTO,68,91,-23,-34%
03-08-2016,60150,TULIP15SKLBTX,17,45,-28,-165%
09-04-2016,199,PARTS,64,62,2,3%
24-12-2017,63254,REDWOODBSKLBTX,98,16,82,84%
23-08-2015,55724,CEDAR14HSWBTX,76,24,52,68%
01-01-2015,60147,TULIP15BDWBTX,66,91,-25,-38%
08-08-2016,62904,BEAVERCREEK12BTX,82,95,-13,-16%
22-02-2017,199,PARTS,17,83,-66,-388%
18-07-2017,199,PARTS,88,69,19,22%
18-01-2016,64250,JAYTONSECUREBTX,82,73,9,11%
11-03-2015,64250,JAYTONSECUREBTX,22,55,-33,-150%
22-08-2017,64250,JAYTONSECUREBTX,75,77,-2,-3%
28-04-2015,60147,TULIP15BDWBTX,21,30,-9,-43%
26-10-2016,60150,TULIP15SKLBTX,53,9,44,83%
30-06-2017,199,PARTS,49,74,-25,-51%
01-06-2015,199,PARTS,19,1,18,95%
24-01-2017,199,PARTS,59,91,-32,-54%
01-12-2017,64250,JAYTONSECUREBTX,32,46,-14,-44%
12-09-2015,199,PARTS,4,20,-16,-400%
17-06-2017,64250,JAYTONSECUREBTX,5,2,3,60%
02-03-2017,82280,PR54499PLANOB,22,17,5,23%
23-05-2016,62904,BEAVERCREEK12BTX,79,4,75,95%
02-11-2015,64250,JAYTONSECUREBTX,52,61,-9,-17%
20-09-2017,56744,MARBLE FALLS14BTX,51,26,25,49%
10-06-2017,57525,HOUSTON15BTX,87,76,11,13%
15-01-2016,59384,IRIS15BDWBTX,31,4,27,87%
12-02-2017,61333,BERLINETTA P,55,73,-18,-33%
18-11-2016,199,PARTS,82,35,47,57%
01-08-2017,74484,PR49941GOL12MLKO,99,15,84,85%
21-09-2016,83944,PR55369GO12MLKOE,76,67,9,12%
01-07-2016,73756,PR49515ERIKSNATG,76,3,73,96%
13-07-2016,63397,ECHO 15 MLK CTO,88,46,42,48%
12-04-2017,64250,JAYTONSECUREBTX,93,85,8,9%
12-01-2015,64250,JAYTONSECUREBTX,32,47,-15,-47%
17-01-2016,64250,JAYTONSECUREBTX,98,25,73,74%
19-07-2015,74473,PR49913ERIKSNATG,13,17,-4,-31%
08-03-2016,62904,BEAVERCREEK12BTX,55,23,32,58%
01-06-2016,199,PARTS,95,90,5,5%
28-12-2015,61336,BERLINETTAPCTO,34,15,19,56%
06-12-2016,199,PARTS,88,56,32,36%
22-01-2017,62904,BEAVERCREEK12BTX,9,76,-67,-744%
10-05-2015,57637,FOXGLOVEBTX,67,85,-18,-27%
03-04-2017,63251,BLACKWOODSKLBTX,86,19,67,78%
04-08-2017,199,PARTS,31,68,-37,-119%
30-06-2017,63251,BLACKWOODSKLBTX,84,50,34,40%
06-04-2017,63251,BLACKWOODSKLBTX,58,70,-12,-21%
18-09-2015,199,PARTS,46,93,-47,-102%
01-03-2016,57499,GOLIADMLK14BTXE,54,96,-42,-78%
06-03-2016,62853,PARKCITY14BTX,44,98,-54,-123%
06-11-2017,55727,CEDAR14BDWBTX,37,54,-17,-46%
02-11-2016,57616,CRESTED BUTTEBTX,71,51,20,28%
01-07-2016,59383,IRIS15BSWBTX,18,13,5,28%
17-09-2015,63251,BLACKWOODSKLBTX,40,90,-50,-125%
07-08-2016,62884,LOVELAND15SBTX,13,18,-5,-38%
01-10-2015,70524,PRGOLIADMLK123,98,16,82,84%
09-08-2015,62904,BEAVERCREEK12BTX,44,62,-18,-41%
30-08-2017,199,PARTS,64,17,47,73%
17-03-2015,62853,PARKCITY14BTX,69,90,-21,-30%
26-11-2017,57494,GOLIADMLK12BTXE,18,83,-65,-361%
11-08-2017,199,PARTS,20,80,-60,-300%
09-04-2017,62907,BEAVERCREEK14BTX,63,30,33,52%
24-01-2015,62907,BEAVERCREEK14BTX,45,48,-3,-7%
18-11-2015,62907,BEAVERCREEK14BTX,98,2,96,98%
28-06-2016,60707,VANGOGH15SKLBTX,100,23,77,77%
12-12-2017,53291,DIESEL 15,39,99,-60,-154%
31-03-2016,61341,MIRAMAR 17,45,16,29,64%
06-02-2017,57454,JANUS15BDWBTX,90,29,61,68%
30-10-2015,199,PARTS,75,21,54,72%
21-06-2015,62907,BEAVERCREEK14BTX,65,84,-19,-29%
11-12-2017,60707,VANGOGH15SKLBTX,99,8,91,92%
01-03-2017,199,PARTS,90,32,58,64%
06-11-2015,56517,REDWOODBTX,3,60,-57,-1900%
20-04-2016,199,PARTS,14,13,1,7%
02-07-2015,199,PARTS,89,90,-1,-1%
27-10-2015,57499,GOLIADMLK14BTXE,84,33,51,61%
27-10-2015,78228,PR51900GOL14MLKA,44,5,39,89%
04-09-2015,199,PARTS,51,75,-24,-47%
15-09-2016,57499,GOLIADMLK14BTXE,84,92,-8,-10%
27-09-2015,68337,ROUND ROCKMLKBTX,94,98,-4,-4%
12-01-2015,79975,PR52942SALADO14,31,81,-50,-161%
08-02-2017,83647,PR47515RNDRCKMLK,7,79,-72,-1029%
08-08-2017,199,PARTS,19,35,-16,-84%
02-04-2015,62904,BEAVERCREEK12BTX,44,75,-31,-70%
25-12-2015,62879,LOVELAND15BBTX,3,13,-10,-333%
27-02-2016,56746,MARBLE FALLS15BTX,27,5,22,81%
08-02-2015,60151,TULIP17SKLBTX,95,5,90,95%
23-06-2016,60704,VANGOGH14BDWBTX,43,2,41,95%
10-05-2016,53301,DIESEL15GREYFED,53,13,40,75%
08-08-2015,57521,HOUSTON14CTO,54,53,1,2%
09-10-2016,60150,TULIP15SKLBTX,3,82,-79,-2633%
26-11-2017,63251,BLACKWOODSKLBTX,58,7,51,88%
06-11-2015,57368,FIGTREECTO,89,22,67,75%
08-08-2015,199,PARTS,16,1,15,94%
06-11-2015,57617,CRESTED BUTTECTO,18,63,-45,-250%
17-08-2017,70901,ROCKET11BSWBTX,79,21,58,73%
22-08-2017,57284,REDWOODHSWBTX,31,46,-15,-48%
02-07-2017,56553,BRADLEYBDWBTX,58,53,5,9%
23-06-2016,56553,BRADLEYBDWBTX,22,58,-36,-164%
01-12-2015,56553,BRADLEYBDWBTX,67,100,-33,-49%
15-09-2015,62908,BEAVERCREEK14CTO,82,5,77,94%
28-10-2015,74493,PR49939SALADO14,68,68,0,0%
03-06-2017,52370,SALADO 14,40,94,-54,-135%
04-12-2017,60813,BERLINETTABTX,81,82,-1,-1%
07-05-2015,60813,BERLINETTABTX,71,83,-12,-17%
25-04-2015,60813,BERLINETTABTX,83,23,60,72%
02-02-2015,62879,LOVELAND15BBTX,45,58,-13,-29%
03-01-2016,199,PARTS,12,37,-25,-208%
25-09-2017,56744,MARBLE FALLS14BTX,40,5,35,88%
09-10-2015,62880,LOVELAND15SCTO,36,8,28,78%
02-09-2015,68338,ROUND ROCKMLKCTO,81,100,-19,-23%
13-02-2016,62904,BEAVERCREEK12BTX,38,59,-21,-55%
16-10-2017,60150,TULIP15SKLBTX,12,43,-31,-258%
18-11-2015,60707,VANGOGH15SKLBTX,25,66,-41,-164%
24-01-2016,60704,VANGOGH14BDWBTX,76,86,-10,-13%
24-11-2015,62884,LOVELAND15SBTX,88,41,47,53%
06-02-2016,70901,ROCKET11BSWBTX,92,8,84,91%
01-03-2015,70901,ROCKET11BSWBTX,34,94,-60,-176%
12-02-2015,62856,PARKCITY15BTX,35,8,27,77%
14-08-2016,56151,MAGELLAN14CTO,29,96,-67,-231%
08-06-2015,61590,DINO2BTX,32,31,1,3%
03-04-2016,61590,DINO2BTX,23,9,14,61%
16-01-2016,62853,PARKCITY14BTX,43,61,-18,-42%
04-08-2017,61590,DINO2BTX,74,56,18,24%
29-07-2017,57374,FIGTREETAA1,29,36,-7,-24%
08-03-2016,67623,MONET14SKLBTX,98,71,27,28%
21-04-2016,57519,HOUSTON14BTX,57,97,-40,-70%
18-02-2017,67623,MONET14SKLBTX,39,44,-5,-13%
17-02-2017,62879,LOVELAND15BBTX,98,17,81,83%
05-04-2016,59385,IRIS15SKLBTX,40,59,-19,-48%
20-12-2017,60150,TULIP15SKLBTX,61,65,-4,-7%
20-05-2016,60150,TULIP15SKLBTX,65,37,28,43%
01-10-2015,57617,CRESTED BUTTECTO,49,80,-31,-63%
12-06-2017,62873,PARKCITY14TAA1,54,26,28,52%
20-11-2016,60151,TULIP17SKLBTX,20,81,-61,-305%
08-04-2017,53291,DIESEL 15,81,96,-15,-19%
18-07-2016,199,PARTS,65,21,44,68%
27-09-2016,60151,TULIP17SKLBTX,8,97,-89,-1113%
24-03-2016,60150,TULIP15SKLBTX,24,67,-43,-179%
20-11-2017,199,PARTS,86,78,8,9%
17-09-2015,84807,PR55864RNDRCKMLK,26,4,22,85%
23-01-2016,60150,TULIP15SKLBTX,1,13,-12,-1200%
01-02-2016,57525,HOUSTON15BTX,37,11,26,70%
15-06-2017,60151,TULIP17SKLBTX,9,1,8,89%
20-09-2015,59383,IRIS15BSWBTX,17,87,-70,-412%
02-09-2016,62856,PARKCITY15BTX,35,87,-52,-149%
15-01-2015,62904,BEAVERCREEK12BTX,13,79,-66,-508%
17-08-2017,55724,CEDAR14HSWBTX,17,76,-59,-347%
27-05-2016,55725,CEDAR15HSWBTX,16,65,-49,-306%
03-01-2017,62881,LOVELAND14SBTX,60,23,37,62%
01-08-2017,60151,TULIP17SKLBTX,55,95,-40,-73%
20-05-2017,64250,JAYTONSECUREBTX,20,81,-61,-305%
19-10-2016,61239,REDWOODMLKBSWBTX,34,18,16,47%
08-09-2016,64250,JAYTONSECUREBTX,88,69,19,22%
16-04-2016,60151,TULIP17SKLBTX,35,66,-31,-89%
02-05-2017,72825,PR48929HOUSTN14O,18,67,-49,-272%
18-05-2016,62877,LOVELAND14BBTX,97,49,48,49%
17-03-2015,63395,ECHO 13 MLK CTO,66,38,28,42%
25-03-2015,56746,MARBLE FALLS15BTX,67,25,42,63%
28-11-2016,56746,MARBLE FALLS15BTX,12,22,-10,-83%
25-08-2016,73929,DRAXBTX,60,12,48,80%
13-08-2017,63251,BLACKWOODSKLBTX,94,46,48,51%
31-07-2017,61590,DINO2BTX,4,68,-64,-1600%
29-08-2016,75809,PR38292GOLI12MLK,23,45,-22,-96%
07-10-2016,199,PARTS,34,52,-18,-53%
27-04-2016,60149,TULIP14SKLBTX,49,92,-43,-88%
02-11-2016,59385,IRIS15SKLBTX,8,61,-53,-663%
16-07-2015,60150,TULIP15SKLBTX,59,26,33,56%
26-12-2015,63886,PANDORA15SKLBTX,86,6,80,93%
06-03-2017,60151,TULIP17SKLBTX,91,1,90,99%
26-02-2015,80400,PR53209GO14MLKAE,69,11,58,84%
11-05-2017,199,PARTS,36,31,5,14%
20-02-2016,67623,MONET14SKLBTX,25,58,-33,-132%
02-06-2017,63251,BLACKWOODSKLBTX,87,44,43,49%
22-11-2017,68337,ROUND ROCKMLKBTX,4,24,-20,-500%
15-10-2017,62853,PARKCITY14BTX,93,78,15,16%
01-10-2016,53512,GOLIAD 14,46,58,-12,-26%
17-04-2015,60150,TULIP15SKLBTX,15,81,-66,-440%
25-11-2017,63253,REDWOODSKLBTX,60,86,-26,-43%
27-09-2015,55725,CEDAR15HSWBTX,64,61,3,5%
28-03-2015,60705,VANGOGH15BDWBTX,14,97,-83,-593%
08-07-2017,57624,CRESTEDBUTTETAA1,26,73,-47,-181%
28-05-2017,60151,TULIP17SKLBTX,70,8,62,89%
22-03-2017,60151,TULIP17SKLBTX,64,5,59,92%
15-06-2015,57497,GOLIADMLK14CTOE,14,24,-10,-71%
29-10-2017,57497,GOLIADMLK14CTOE,42,81,-39,-93%
28-01-2015,199,PARTS,10,90,-80,-800%
31-03-2015,62904,BEAVERCREEK12BTX,29,64,-35,-121%
01-12-2017,62877,LOVELAND14BBTX,95,42,53,56%
14-03-2016,60705,VANGOGH15BDWBTX,7,71,-64,-914%
03-03-2016,61333,BERLINETTA P,60,76,-16,-27%
21-02-2015,199,PARTS,95,52,43,45%
07-12-2015,57497,GOLIADMLK14CTOE,27,9,18,67%
08-09-2015,57495,GOLIADMLK12CTOE,71,40,31,44%
29-05-2016,55725,CEDAR15HSWBTX,72,89,-17,-24%
10-10-2017,199,PARTS,95,46,49,52%
14-07-2017,473,NON_TIED_PERIPHERALS,23,10,13,57%
05-12-2016,60151,TULIP17SKLBTX,8,17,-9,-113%
17-06-2015,63039,PARKCITY-P15CTO,47,12,35,74%
15-03-2017,199,PARTS,59,73,-14,-24%
02-08-2017,60706,VANGOGH14SKLBTX,20,15,5,25%
22-06-2016,60150,TULIP15SKLBTX,3,53,-50,-1667%
22-10-2015,62882,LOVELAND14SCTO,78,45,33,42%
05-05-2017,59670,PLANOBCTO,97,69,28,29%
11-02-2015,57499,GOLIADMLK14BTXE,17,90,-73,-429%
12-12-2016,67623,MONET14SKLBTX,75,60,15,20%
19-10-2016,57499,GOLIADMLK14BTXE,81,3,78,96%
25-03-2017,199,PARTS,25,62,-37,-148%
27-07-2016,57499,GOLIADMLK14BTXE,84,57,27,32%
23-04-2016,60705,VANGOGH15BDWBTX,3,1,2,67%
09-03-2015,57190,ERIKSSON14BTX,35,39,-4,-11%
14-09-2015,199,PARTS,44,66,-22,-50%
09-11-2015,57527,HOUSTON15CTO,68,94,-26,-38%
16-11-2017,57527,HOUSTON15CTO,38,6,32,84%
15-01-2016,199,PARTS,58,65,-7,-12%
09-04-2017,68338,ROUND ROCKMLKCTO,24,48,-24,-100%
02-04-2015,57499,GOLIADMLK14BTXE,88,3,85,97%
01-11-2015,57499,GOLIADMLK14BTXE,10,14,-4,-40%
26-11-2017,57499,GOLIADMLK14BTXE,47,46,1,2%
17-05-2015,59383,IRIS15BSWBTX,7,63,-56,-800%
04-01-2016,84417,PR55770BLACKWELL,94,5,89,95%
27-07-2017,199,PARTS,18,1,17,94%
20-11-2017,58167,ECHO 17 CTO,93,64,29,31%
11-08-2016,62904,BEAVERCREEK12BTX,77,28,49,64%
08-06-2015,55725,CEDAR15HSWBTX,37,74,-37,-100%
22-01-2016,62904,BEAVERCREEK12BTX,77,2,75,97%
24-12-2016,62904,BEAVERCREEK12BTX,51,27,24,47%
18-09-2016,62850,PARKCITY12BTX,51,6,45,88%
21-05-2016,81756,PR54119GO14MLKAE,25,80,-55,-220%
13-03-2016,62856,PARKCITY15BTX,17,100,-83,-488%
30-04-2017,60706,VANGOGH14SKLBTX,55,56,-1,-2%
08-06-2017,69925,CELTICCTO,20,73,-53,-265%
04-11-2017,57190,ERIKSSON14BTX,72,96,-24,-33%
23-04-2015,199,PARTS,28,77,-49,-175%
22-02-2016,73810,PR43339GOLI14MLK,91,21,70,77%
08-12-2016,62877,LOVELAND14BBTX,37,41,-4,-11%
23-09-2016,68337,ROUND ROCKMLKBTX,18,96,-78,-433%
28-07-2017,64248,JAYTONBTX,69,81,-12,-17%
30-11-2016,60148,TULIP17BDWBTX,37,97,-60,-162%
07-08-2015,70899,PR29256CRESBUTTE,35,76,-41,-117%
10-08-2016,57526,HOUSTON15CTOE,79,39,40,51%
23-02-2017,62856,PARKCITY15BTX,7,25,-18,-257%
30-06-2016,60706,VANGOGH14SKLBTX,33,26,7,21%
10-08-2016,62850,PARKCITY12BTX,55,73,-18,-33%
30-06-2017,60147,TULIP15BDWBTX,4,92,-88,-2200%
18-10-2017,61612,PR36023GOLIAD14,24,35,-11,-46%
08-02-2017,62905,BEAVERCREEK12CTO,38,41,-3,-8%
24-09-2016,53292,DIESEL 17,21,80,-59,-281%
05-04-2016,60146,TULIP14BDWBTX,5,79,-74,-1480%
27-09-2016,52371,SALADO 15,21,13,8,38%
10-03-2015,59384,IRIS15BDWBTX,100,73,27,27%
09-08-2016,199,PARTS,54,52,2,4%
02-09-2017,60705,VANGOGH15BDWBTX,58,26,32,55%
01-01-2016,57517,HOUSTON12TAA,22,77,-55,-250%
30-06-2016,57284,REDWOODHSWBTX,22,61,-39,-177%
07-10-2017,56745,MARBLE FALLS15CTO,19,65,-46,-242%
08-02-2015,199,PARTS,83,68,15,18%
10-01-2017,62856,PARKCITY15BTX,73,34,39,53%
02-08-2015,199,PARTS,17,26,-9,-53%
06-12-2016,62904,BEAVERCREEK12BTX,10,84,-74,-740%
17-07-2017,62856,PARKCITY15BTX,73,92,-19,-26%
05-12-2017,62853,PARKCITY14BTX,40,9,31,78%
01-11-2017,62878,LOVELAND14BCTO,54,35,19,35%
18-01-2016,75863,PR50769SILVERTON,15,93,-78,-520%
12-01-2017,62908,BEAVERCREEK14CTO,13,66,-53,-408%
11-07-2017,62884,LOVELAND15SBTX,38,1,37,97%
24-01-2015,60153,TULIP15AMDBTX,99,45,54,55%
03-03-2017,199,PARTS,72,26,46,64%
19-02-2017,60153,TULIP15AMDBTX,100,46,54,54%
22-10-2015,56553,BRADLEYBDWBTX,31,75,-44,-142%
01-08-2016,56553,BRADLEYBDWBTX,57,100,-43,-75%
28-12-2017,63039,PARKCITY-P15CTO,75,69,6,8%
13-01-2017,53291,DIESEL 15,3,23,-20,-667%
13-03-2016,57495,GOLIADMLK12CTOE,59,53,6,10%
17-10-2016,57495,GOLIADMLK12CTOE,32,31,1,3%
09-10-2017,62904,BEAVERCREEK12BTX,85,9,76,89%
21-06-2015,60147,TULIP15BDWBTX,36,71,-35,-97%
21-05-2015,74192,DRAXSKLYBTX,26,68,-42,-162%
10-04-2017,60813,BERLINETTABTX,39,84,-45,-115%
18-08-2016,62856,PARKCITY15BTX,48,38,10,21%
21-03-2015,57497,GOLIADMLK14CTOE,37,35,2,5%
01-12-2017,57499,GOLIADMLK14BTXE,51,4,47,92%
15-01-2015,199,PARTS,86,25,61,71%
10-06-2017,62850,PARKCITY12BTX,40,53,-13,-33%
02-10-2017,64248,JAYTONBTX,92,72,20,22%
11-05-2015,66803,SOMERSETBTX,62,12,50,81%
27-03-2015,56745,MARBLE FALLS15CTO,45,49,-4,-9%
06-02-2015,62884,LOVELAND15SBTX,69,94,-25,-36%
14-12-2017,56746,MARBLE FALLS15BTX,26,58,-32,-123%
16-10-2017,56746,MARBLE FALLS15BTX,1,37,-36,-3600%
29-07-2015,56745,MARBLE FALLS15CTO,42,82,-40,-95%
05-04-2017,61239,REDWOODMLKBSWBTX,26,38,-12,-46%
24-06-2016,60149,TULIP14SKLBTX,40,71,-31,-78%
20-12-2015,69228,PR46575HOUSTN14O,16,41,-25,-156%
30-09-2016,59379,IRIS14BSWBTX,2,98,-96,-4800%
08-05-2015,59384,IRIS15BDWBTX,52,17,35,67%
10-04-2017,60150,TULIP15SKLBTX,75,65,10,13%
07-04-2015,62853,PARKCITY14BTX,96,42,54,56%
13-09-2016,66803,SOMERSETBTX,62,96,-34,-55%
04-02-2016,66803,SOMERSETBTX,85,72,13,15%
01-08-2015,57525,HOUSTON15BTX,46,81,-35,-76%
02-07-2017,57525,HOUSTON15BTX,43,2,41,95%
11-12-2017,199,PARTS,65,76,-11,-17%
06-04-2015,52332,SALADO14BTX,8,69,-61,-763%
05-07-2017,60146,TULIP14BDWBTX,3,47,-44,-1467%
22-06-2016,199,PARTS,14,22,-8,-57%
21-05-2015,52332,SALADO14BTX,85,46,39,46%
16-05-2016,66803,SOMERSETBTX,9,4,5,56%
06-10-2016,66803,SOMERSETBTX,66,87,-21,-32%
16-10-2016,57379,JEFFERSONBTX,39,91,-52,-133%
22-08-2015,57379,JEFFERSONBTX,28,42,-14,-50%
26-04-2015,57379,JEFFERSONBTX,93,80,13,14%
28-12-2015,57513,HOUSTON12BTX,61,48,13,21%
25-02-2017,61341,MIRAMAR 17,2,63,-61,-3050%
27-09-2015,60813,BERLINETTABTX,19,81,-62,-326%
11-03-2015,60149,TULIP14SKLBTX,19,47,-28,-147%
09-04-2015,62857,PARKCITY15CTO,22,42,-20,-91%
03-02-2017,57495,GOLIADMLK12CTOE,43,16,27,63%
22-10-2015,57515,HOUSTON12CTO,79,76,3,4%
18-08-2016,55724,CEDAR14HSWBTX,86,87,-1,-1%
02-07-2016,57379,JEFFERSONBTX,54,66,-12,-22%
24-12-2016,60150,TULIP15SKLBTX,10,57,-47,-470%
11-10-2015,60150,TULIP15SKLBTX,87,81,6,7%
11-10-2017,56743,MARBLE FALLS14CTO,46,92,-46,-100%
19-09-2016,62904,BEAVERCREEK12BTX,84,80,4,5%
25-05-2016,62854,PARKCITY14CTO,64,15,49,77%
31-01-2015,62884,LOVELAND15SBTX,34,55,-21,-62%
28-11-2015,63039,PARKCITY-P15CTO,20,8,12,60%
03-09-2015,62883,LOVELAND15BCTO,88,22,66,75%
14-06-2015,57379,JEFFERSONBTX,34,71,-37,-109%
13-09-2017,82514,PR41576SOMERSET,83,60,23,28%
05-09-2017,62856,PARKCITY15BTX,51,59,-8,-16%
25-12-2017,61173,JASBSW20BTX,73,87,-14,-19%
05-01-2017,60153,TULIP15AMDBTX,36,13,23,64%
01-01-2017,66803,SOMERSETBTX,29,65,-36,-124%
30-10-2016,60150,TULIP15SKLBTX,30,44,-14,-47%
13-05-2015,77472,PR32591HOUSTN12E,64,13,51,80%
02-07-2016,57379,JEFFERSONBTX,53,66,-13,-25%
09-06-2015,57379,JEFFERSONBTX,56,61,-5,-9%
18-09-2015,57455,TITAN14MLKBDWBTX,63,24,39,62%
03-10-2017,57455,TITAN14MLKBDWBTX,41,65,-24,-59%
18-06-2017,55724,CEDAR14HSWBTX,54,37,17,31%
25-01-2015,199,PARTS,54,87,-33,-61%
08-12-2016,57455,TITAN14MLKBDWBTX,92,99,-7,-8%
07-04-2015,57523,HOUSTON14TAA,28,72,-44,-157%
10-06-2016,57379,JEFFERSONBTX,73,74,-1,-1%
23-10-2015,57379,JEFFERSONBTX,70,10,60,86%
21-07-2017,60812,VENENOBTX,42,14,28,67%
11-05-2015,62877,LOVELAND14BBTX,5,48,-43,-860%
07-05-2017,62856,PARKCITY15BTX,53,46,7,13%
14-10-2015,59384,IRIS15BDWBTX,64,31,33,52%
08-05-2017,62881,LOVELAND14SBTX,53,93,-40,-75%
13-05-2015,60707,VANGOGH15SKLBTX,64,87,-23,-36%
31-10-2017,60147,TULIP15BDWBTX,12,29,-17,-142%
07-10-2017,199,PARTS,30,20,10,33%
06-01-2015,57379,JEFFERSONBTX,45,86,-41,-91%
18-07-2017,59384,IRIS15BDWBTX,27,37,-10,-37%
22-04-2016,60151,TULIP17SKLBTX,62,42,20,32%
28-08-2016,199,PARTS,93,85,8,9%
21-04-2016,57525,HOUSTON15BTX,77,64,13,17%
23-04-2016,62884,LOVELAND15SBTX,23,88,-65,-283%
25-02-2015,62884,LOVELAND15SBTX,83,24,59,71%
26-10-2017,60812,VENENOBTX,27,12,15,56%
20-10-2016,63886,PANDORA15SKLBTX,50,79,-29,-58%
27-06-2016,69923,CELTICBTX,27,100,-73,-270%
26-09-2017,79738,PR52762GO14MLKOE,5,53,-48,-960%
21-10-2015,83527,PR55286GO14MLKAE,49,60,-11,-22%
22-08-2017,199,PARTS,85,41,44,52%
30-12-2017,52332,SALADO14BTX,20,36,-16,-80%
21-03-2016,56744,MARBLE FALLS14BTX,1,76,-75,-7500%
23-05-2017,199,PARTS,46,92,-46,-100%
07-06-2017,61590,DINO2BTX,36,1,35,97%
24-07-2015,57379,JEFFERSONBTX,36,36,0,0%
16-03-2016,56744,MARBLE FALLS14BTX,30,95,-65,-217%
23-05-2016,56744,MARBLE FALLS14BTX,99,50,49,49%
20-03-2015,61590,DINO2BTX,64,65,-1,-2%
16-12-2016,199,PARTS,27,65,-38,-141%
30-10-2016,59515,BELMONTBTX,46,94,-48,-104%
16-10-2016,57379,JEFFERSONBTX,58,79,-21,-36%
12-03-2015,57379,JEFFERSONBTX,34,31,3,9%
17-03-2017,57495,GOLIADMLK12CTOE,89,41,48,54%
08-04-2017,62904,BEAVERCREEK12BTX,47,86,-39,-83%
03-05-2017,79082,PR52310DIESEL15,98,58,40,41%
27-12-2016,59669,PLANOMBTX,39,1,38,97%
01-07-2016,63034,MIRAMAR15TAA1,77,17,60,78%
26-08-2016,52332,SALADO14BTX,43,92,-49,-114%
27-03-2016,62884,LOVELAND15SBTX,84,22,62,74%
29-10-2015,199,PARTS,45,92,-47,-104%
28-05-2017,57521,HOUSTON14CTO,36,74,-38,-106%
07-09-2017,57527,HOUSTON15CTO,20,7,13,65%
17-07-2015,63886,PANDORA15SKLBTX,45,17,28,62%
22-04-2017,72828,PR48813MAGELLXFR,78,12,66,85%
13-12-2017,80751,PR53454BVRCRK12O,89,2,87,98%
30-04-2016,84440,PR55637BVRCRK14A,71,12,59,83%
22-06-2017,60150,TULIP15SKLBTX,49,87,-38,-78%
21-05-2015,57495,GOLIADMLK12CTOE,13,92,-79,-608%
22-08-2015,62884,LOVELAND15SBTX,88,4,84,95%
19-07-2016,75087,PR50150TESTAROSP,95,72,23,24%
13-08-2016,62856,PARKCITY15BTX,4,25,-21,-525%
30-11-2017,65308,BLACKWELLT4BTX,85,33,52,61%
17-05-2015,63397,ECHO 15 MLK CTO,24,84,-60,-250%
13-10-2015,62912,BEAVERCREEK12FTAA,11,84,-73,-664%
15-01-2017,199,PARTS,57,11,46,81%
11-01-2016,199,PARTS,51,17,34,67%
23-10-2015,62856,PARKCITY15BTX,1,63,-62,-6200%
29-11-2017,52370,SALADO 14,83,51,32,39%
17-09-2015,52332,SALADO14BTX,36,8,28,78%
05-03-2017,76926,PR51307DIESEL17,30,72,-42,-140%
18-09-2015,60147,TULIP15BDWBTX,23,54,-31,-135%
07-11-2017,56153,COLUMBUS12CTO,89,40,49,55%
02-06-2016,56153,COLUMBUS12CTO,61,87,-26,-43%
21-10-2016,57354,ECHO 13FCTO,46,29,17,37%
22-12-2015,81747,PR53907COLUMXFR,13,75,-62,-477%
07-03-2016,199,PARTS,72,63,9,13%
11-10-2015,60147,TULIP15BDWBTX,45,47,-2,-4%
19-06-2016,62907,BEAVERCREEK14BTX,83,45,38,46%
23-11-2015,78229,PR51899GOL14MLKA,95,95,0,0%
03-12-2015,199,PARTS,38,74,-36,-95%
19-02-2017,81741,PR53946BVRCRK14O,25,67,-42,-168%
04-12-2017,62856,PARKCITY15BTX,96,65,31,32%
16-06-2016,60822,BOLDPEAK2BTX,41,20,21,51%
15-06-2017,55757,MAPLEM14BDWBTX,92,44,48,52%
16-10-2016,62857,PARKCITY15CTO,72,22,50,69%
04-09-2017,61339,MIRAMAR 15,56,99,-43,-77%
04-11-2017,60704,VANGOGH14BDWBTX,14,46,-32,-229%
02-04-2016,77831,PR45417HOUSTON14,91,58,33,36%
21-11-2015,62884,LOVELAND15SBTX,39,57,-18,-46%
27-10-2017,62856,PARKCITY15BTX,41,11,30,73%
03-09-2016,60147,TULIP15BDWBTX,42,77,-35,-83%
22-02-2016,59379,IRIS14BSWBTX,17,70,-53,-312%
12-07-2015,60813,BERLINETTABTX,59,46,13,22%
01-06-2016,62904,BEAVERCREEK12BTX,8,53,-45,-563%
30-03-2016,60147,TULIP15BDWBTX,3,97,-94,-3133%
29-05-2017,54984,ROUND ROCKBTX,89,85,4,4%
26-04-2017,54984,ROUND ROCKBTX,72,35,37,51%
20-06-2017,76959,PR51082LIVNGSTON,34,58,-24,-71%
29-08-2017,77339,PR51386HOUSTN14O,58,2,56,97%
05-06-2017,60146,TULIP14BDWBTX,13,73,-60,-462%
23-10-2016,62886,LOVELAND14FBCTO,26,79,-53,-204%
08-02-2016,60151,TULIP17SKLBTX,29,55,-26,-90%
03-06-2015,61239,REDWOODMLKBSWBTX,85,90,-5,-6%
31-01-2017,57519,HOUSTON14BTX,28,6,22,79%
04-04-2015,199,PARTS,63,37,26,41%
23-05-2016,64250,JAYTONSECUREBTX,21,47,-26,-124%
04-05-2015,60704,VANGOGH14BDWBTX,74,73,1,1%
01-03-2015,52370,SALADO 14,61,93,-32,-52%
29-12-2015,62882,LOVELAND14SCTO,13,25,-12,-92%
20-02-2017,52370,SALADO 14,62,76,-14,-23%
03-06-2015,52370,SALADO 14,30,96,-66,-220%
05-04-2017,38851,SQUEEZE,53,13,40,75%
28-03-2015,199,PARTS,17,92,-75,-441%
13-03-2016,62857,PARKCITY15CTO,74,58,16,22%
16-07-2016,57519,HOUSTON14BTX,7,99,-92,-1314%
13-08-2017,57368,FIGTREECTO,41,85,-44,-107%
02-01-2016,62856,PARKCITY15BTX,50,30,20,40%
12-11-2016,52370,SALADO 14,95,95,0,0%
06-02-2017,62854,PARKCITY14CTO,35,75,-40,-114%
17-12-2016,199,PARTS,50,47,3,6%
23-05-2016,60153,TULIP15AMDBTX,93,9,84,90%
07-06-2017,56858,PANDORA14HSWBTX,78,39,39,50%
06-08-2015,62853,PARKCITY14BTX,77,30,47,61%
17-09-2017,60153,TULIP15AMDBTX,95,57,38,40%
20-10-2015,57519,HOUSTON14BTX,33,89,-56,-170%
10-04-2016,199,PARTS,55,66,-11,-20%
16-06-2015,199,PARTS,93,91,2,2%
23-08-2017,60704,VANGOGH14BDWBTX,15,92,-77,-513%
06-01-2016,60150,TULIP15SKLBTX,14,87,-73,-521%
19-06-2015,61173,JASBSW20BTX,40,96,-56,-140%
31-07-2017,57519,HOUSTON14BTX,56,94,-38,-68%
18-08-2017,57515,HOUSTON12CTO,88,12,76,86%
24-11-2017,64250,JAYTONSECUREBTX,28,32,-4,-14%
10-10-2017,61239,REDWOODMLKBSWBTX,2,54,-52,-2600%
20-05-2017,60153,TULIP15AMDBTX,94,55,39,41%
17-10-2016,57494,GOLIADMLK12BTXE,15,18,-3,-20%
06-09-2016,199,PARTS,98,76,22,22%
03-02-2016,57519,HOUSTON14BTX,70,36,34,49%
19-01-2017,60153,TULIP15AMDBTX,70,83,-13,-19%
26-05-2015,57494,GOLIADMLK12BTXE,49,34,15,31%
26-07-2016,57494,GOLIADMLK12BTXE,90,48,42,47%
25-04-2017,57519,HOUSTON14BTX,52,55,-3,-6%
01-12-2017,78305,PR44822GOLI14MLK,17,25,-8,-47%
11-07-2016,52370,SALADO 14,32,44,-12,-38%
27-09-2017,61341,MIRAMAR 17,53,51,2,4%
14-05-2017,57494,GOLIADMLK12BTXE,11,31,-20,-182%
06-05-2015,60704,VANGOGH14BDWBTX,82,23,59,72%
26-12-2016,57519,HOUSTON14BTX,81,40,41,51%
03-03-2015,60153,TULIP15AMDBTX,28,24,4,14%
03-11-2015,57527,HOUSTON15CTO,41,83,-42,-102%
26-08-2016,61339,MIRAMAR 15,48,56,-8,-17%
05-06-2016,62881,LOVELAND14SBTX,14,98,-84,-600%
17-07-2015,57494,GOLIADMLK12BTXE,71,56,15,21%
09-12-2017,63256,COTTONWOODSKLBTX,69,37,32,46%
24-02-2017,62854,PARKCITY14CTO,15,30,-15,-100%
25-05-2016,60150,TULIP15SKLBTX,48,65,-17,-35%
25-02-2017,70901,ROCKET11BSWBTX,58,34,24,41%
15-11-2016,54142,TESTAROSSA P,69,11,58,84%
29-09-2015,57521,HOUSTON14CTO,34,63,-29,-85%
07-01-2016,58167,ECHO 17 CTO,92,52,40,43%
22-06-2016,62880,LOVELAND15SCTO,22,8,14,64%
11-12-2017,57519,HOUSTON14BTX,57,23,34,60%
10-08-2015,60704,VANGOGH14BDWBTX,88,15,73,83%
15-05-2017,57521,HOUSTON14CTO,2,6,-4,-200%
08-05-2017,60150,TULIP15SKLBTX,90,84,6,7%
21-02-2015,60148,TULIP17BDWBTX,46,66,-20,-43%
29-07-2016,199,PARTS,5,32,-27,-540%
03-04-2016,60153,TULIP15AMDBTX,52,77,-25,-48%
12-02-2017,68976,PRGOLIADMLK143,40,27,13,33%
01-05-2017,62856,PARKCITY15BTX,32,97,-65,-203%
20-01-2017,59381,IRIS14SKLBTX,21,42,-21,-100%
14-07-2016,60153,TULIP15AMDBTX,95,100,-5,-5%
08-08-2017,60153,TULIP15AMDBTX,87,50,37,43%
07-01-2015,55757,MAPLEM14BDWBTX,9,93,-84,-933%
12-10-2015,57497,GOLIADMLK14CTOE,86,60,26,30%
29-04-2017,64248,JAYTONBTX,47,48,-1,-2%
29-05-2015,57525,HOUSTON15BTX,81,27,54,67%
05-01-2015,57519,HOUSTON14BTX,49,50,-1,-2%
11-09-2017,57494,GOLIADMLK12BTXE,8,59,-51,-638%
12-12-2017,55725,CEDAR15HSWBTX,26,46,-20,-77%
10-07-2017,60147,TULIP15BDWBTX,11,21,-10,-91%
20-10-2016,199,PARTS,37,41,-4,-11%
25-08-2015,53850,DIESEL15CTO,56,91,-35,-63%
28-05-2017,54983,ROUND ROCK,65,37,28,43%
08-08-2015,60706,VANGOGH14SKLBTX,93,43,50,54%
11-10-2016,60150,TULIP15SKLBTX,67,30,37,55%
01-07-2017,199,PARTS,30,37,-7,-23%
15-07-2015,63039,PARKCITY-P15CTO,58,20,38,66%
01-05-2015,56743,MARBLE FALLS14CTO,31,58,-27,-87%
01-07-2017,62905,BEAVERCREEK12CTO,41,27,14,34%
24-11-2017,54983,ROUND ROCK,88,12,76,86%
10-03-2017,62907,BEAVERCREEK14BTX,45,71,-26,-58%
17-09-2017,62904,BEAVERCREEK12BTX,49,2,47,96%
03-07-2016,61590,DINO2BTX,55,59,-4,-7%
30-06-2016,59379,IRIS14BSWBTX,19,20,-1,-5%
19-08-2015,56744,MARBLE FALLS14BTX,95,88,7,7%
23-11-2017,61590,DINO2BTX,80,98,-18,-23%
05-05-2015,62870,PARKCITY12TAA1,65,28,37,57%
12-04-2017,61339,MIRAMAR 15,1,42,-41,-4100%
17-09-2017,62881,LOVELAND14SBTX,42,79,-37,-88%
29-11-2015,73518,PR49272HOUSTN14O,56,22,34,61%
23-02-2015,63039,PARKCITY-P15CTO,17,24,-7,-41%
24-05-2016,70901,ROCKET11BSWBTX,87,58,29,33%
30-11-2017,73118,PR49144ERIKSNATG,65,92,-27,-42%
04-12-2017,62881,LOVELAND14SBTX,44,33,11,25%
06-12-2016,199,PARTS,31,8,23,74%
27-06-2015,62907,BEAVERCREEK14BTX,79,5,74,94%
31-01-2015,64248,JAYTONBTX,52,49,3,6%
24-03-2017,60704,VANGOGH14BDWBTX,47,78,-31,-66%
01-02-2015,77347,PR51434SALADO14,23,36,-13,-57%
24-04-2017,60153,TULIP15AMDBTX,87,86,1,1%
01-06-2017,199,PARTS,13,93,-80,-615%
08-11-2017,57497,GOLIADMLK14CTOE,87,70,17,20%
01-01-2016,62881,LOVELAND14SBTX,23,90,-67,-291%
18-10-2017,60150,TULIP15SKLBTX,22,44,-22,-100%
02-04-2015,70901,ROCKET11BSWBTX,87,35,52,60%
14-12-2016,54983,ROUND ROCK,89,27,62,70%
15-01-2015,199,PARTS,85,45,40,47%
15-10-2017,60151,TULIP17SKLBTX,37,67,-30,-81%
13-02-2015,68934,PR46459PLANOM,39,90,-51,-131%
01-04-2015,60153,TULIP15AMDBTX,27,59,-32,-119%
07-08-2016,61333,BERLINETTA P,19,3,16,84%
12-01-2016,62889,LOVELAND15FBBTX,14,91,-77,-550%
10-11-2015,57616,CRESTED BUTTEBTX,1,89,-88,-8800%
28-08-2017,67526,PRGOLIADMLK141,71,71,0,0%
13-04-2016,73929,DRAXBTX,61,68,-7,-11%
10-04-2015,61590,DINO2BTX,26,73,-47,-181%
05-03-2017,70901,ROCKET11BSWBTX,89,29,60,67%
18-10-2016,60812,VENENOBTX,5,97,-92,-1840%
17-04-2016,60812,VENENOBTX,99,36,63,64%
22-10-2016,199,PARTS,49,42,7,14%
02-11-2017,70901,ROCKET11BSWBTX,70,96,-26,-37%
03-11-2016,63886,PANDORA15SKLBTX,94,30,64,68%
18-01-2017,70901,ROCKET11BSWBTX,6,36,-30,-500%
19-08-2015,199,PARTS,95,68,27,28%
21-12-2016,63886,PANDORA15SKLBTX,8,1,7,88%
15-03-2015,63885,PANDORA15HSWBTX,40,26,14,35%
13-09-2016,69925,CELTICCTO,46,79,-33,-72%
17-06-2015,63095,MERIDIANBTX,65,35,30,46%
26-04-2015,62877,LOVELAND14BBTX,17,6,11,65%
30-08-2017,62907,BEAVERCREEK14BTX,56,1,55,98%
08-09-2017,56743,MARBLE FALLS14CTO,10,12,-2,-20%
12-07-2017,62877,LOVELAND14BBTX,26,47,-21,-81%
02-07-2016,199,PARTS,72,77,-5,-7%
31-03-2017,56743,MARBLE FALLS14CTO,38,39,-1,-3%
21-01-2016,199,PARTS,14,81,-67,-479%
15-07-2017,56746,MARBLE FALLS15BTX,73,10,63,86%
24-10-2017,53292,DIESEL 17,52,68,-16,-31%
20-02-2015,68337,ROUND ROCKMLKBTX,55,74,-19,-35%
06-06-2016,60151,TULIP17SKLBTX,43,30,13,30%
02-02-2016,60153,TULIP15AMDBTX,60,35,25,42%
14-04-2017,71895,PR48149LIVNGSTON,69,6,63,91%
04-08-2015,199,PARTS,3,45,-42,-1400%
30-09-2015,62882,LOVELAND14SCTO,85,14,71,84%
31-08-2017,60153,TULIP15AMDBTX,19,86,-67,-353%
16-01-2015,55727,CEDAR14BDWBTX,63,60,3,5%
23-12-2016,57527,HOUSTON15CTO,76,36,40,53%
19-08-2017,199,PARTS,72,28,44,61%
08-01-2016,55728,CEDAR15BDWBTX,90,64,26,29%
14-02-2015,60153,TULIP15AMDBTX,14,96,-82,-586%
28-09-2016,199,PARTS,40,43,-3,-8%
30-09-2015,57379,JEFFERSONBTX,42,32,10,24%
21-10-2015,55731,CEDAR15AMDBTX,21,46,-25,-119%
28-03-2016,53291,DIESEL 15,25,59,-34,-136%
27-04-2017,199,PARTS,62,89,-27,-44%
09-03-2017,62878,LOVELAND14BCTO,62,9,53,85%
19-10-2017,60813,BERLINETTABTX,90,73,17,19%
09-05-2017,56746,MARBLE FALLS15BTX,46,86,-40,-87%
15-06-2017,62907,BEAVERCREEK14BTX,66,69,-3,-5%
04-08-2015,56744,MARBLE FALLS14BTX,100,78,22,22%
12-06-2016,61239,REDWOODMLKBSWBTX,63,70,-7,-11%
30-06-2017,60153,TULIP15AMDBTX,16,81,-65,-406%
02-03-2017,57455,TITAN14MLKBDWBTX,69,66,3,4%
30-08-2015,60153,TULIP15AMDBTX,32,47,-15,-47%
28-10-2015,57523,HOUSTON14TAA,60,15,45,75%
30-06-2015,57454,JANUS15BDWBTX,87,29,58,67%
11-06-2016,57379,JEFFERSONBTX,45,10,35,78%
27-08-2016,63886,PANDORA15SKLBTX,47,53,-6,-13%
27-11-2016,60148,TULIP17BDWBTX,8,100,-92,-1150%
21-12-2017,60153,TULIP15AMDBTX,46,5,41,89%
27-03-2015,60150,TULIP15SKLBTX,69,53,16,23%
01-05-2017,62905,BEAVERCREEK12CTO,33,20,13,39%
21-07-2016,54142,TESTAROSSA P,36,79,-43,-119%
28-02-2016,69925,CELTICCTO,62,39,23,37%
05-06-2016,473,NON_TIED_PERIPHERALS,7,4,3,43%
22-12-2017,62883,LOVELAND15BCTO,25,33,-8,-32%
18-12-2015,57379,JEFFERSONBTX,43,90,-47,-109%
07-08-2017,63886,PANDORA15SKLBTX,5,89,-84,-1680%
19-02-2016,71181,PR47817HOUSTN15O,48,6,42,88%
26-06-2017,60150,TULIP15SKLBTX,83,64,19,23%
12-03-2016,63886,PANDORA15SKLBTX,46,43,3,7%
29-09-2016,56744,MARBLE FALLS14BTX,65,15,50,77%
23-10-2016,57379,JEFFERSONBTX,66,46,20,30%
16-08-2015,63886,PANDORA15SKLBTX,14,45,-31,-221%
08-10-2016,63886,PANDORA15SKLBTX,23,52,-29,-126%
21-11-2017,52371,SALADO 15,100,56,44,44%
16-03-2016,60151,TULIP17SKLBTX,77,29,48,62%
14-11-2016,199,PARTS,53,7,46,87%
23-10-2015,57455,TITAN14MLKBDWBTX,60,72,-12,-20%
25-04-2017,63886,PANDORA15SKLBTX,52,57,-5,-10%
13-07-2016,63255,COTTONWOODBSKLBTX,18,15,3,17%
31-01-2016,60150,TULIP15SKLBTX,5,61,-56,-1120%
19-07-2016,199,PARTS,85,46,39,46%
14-02-2015,63255,COTTONWOODBSKLBTX,54,53,1,2%
05-08-2017,62907,BEAVERCREEK14BTX,90,34,56,62%
05-01-2017,62904,BEAVERCREEK12BTX,17,10,7,41%
23-08-2015,52333,SALADO15BTX,2,13,-11,-550%
09-08-2017,62884,LOVELAND15SBTX,98,22,76,78%
27-09-2017,62884,LOVELAND15SBTX,2,24,-22,-1100%
01-10-2015,61590,DINO2BTX,73,89,-16,-22%
09-03-2017,199,PARTS,76,63,13,17%
25-06-2016,57624,CRESTEDBUTTETAA1,55,19,36,65%
01-11-2016,62884,LOVELAND15SBTX,16,99,-83,-519%
22-03-2017,79081,PR52438DIESEL15,31,87,-56,-181%
13-04-2015,62850,PARKCITY12BTX,34,22,12,35%
20-12-2017,61590,DINO2BTX,10,65,-55,-550%
21-03-2017,57197,ERIKSSON14CTO1,73,47,26,36%
30-06-2015,52332,SALADO14BTX,75,99,-24,-32%
06-10-2015,199,PARTS,63,40,23,37%
26-01-2015,73774,PR49426HOUSTN14O,39,54,-15,-38%
11-01-2017,71920,PR42434GOLI14MLK,74,2,72,97%
31-10-2016,83936,PR55581BVRCRK14A,22,55,-33,-150%
30-11-2015,62853,PARKCITY14BTX,19,23,-4,-21%
12-11-2017,60150,TULIP15SKLBTX,85,2,83,98%
28-05-2016,61590,DINO2BTX,30,24,6,20%
27-02-2015,61590,DINO2BTX,34,57,-23,-68%
22-10-2017,74469,PR49844COLUMXFR,16,84,-68,-425%
12-03-2016,61590,DINO2BTX,42,97,-55,-131%
26-08-2017,63255,COTTONWOODBSKLBTX,15,22,-7,-47%
16-11-2016,61590,DINO2BTX,18,53,-35,-194%
23-08-2016,61590,DINO2BTX,35,48,-13,-37%
17-07-2015,60150,TULIP15SKLBTX,45,80,-35,-78%
15-05-2017,60822,BOLDPEAK2BTX,97,42,55,57%
16-06-2017,61590,DINO2BTX,70,41,29,41%
30-07-2016,61590,DINO2BTX,86,74,12,14%
09-02-2016,199,PARTS,53,4,49,92%
26-12-2017,63255,COTTONWOODBSKLBTX,31,43,-12,-39%
04-12-2017,57497,GOLIADMLK14CTOE,32,71,-39,-122%
28-01-2016,199,PARTS,79,31,48,61%
06-12-2016,62878,LOVELAND14BCTO,27,80,-53,-196%
18-12-2015,199,PARTS,85,37,48,56%
29-11-2017,74489,PR49943HOUSTN14O,76,40,36,47%
05-11-2016,60151,TULIP17SKLBTX,100,32,68,68%
08-08-2015,63251,BLACKWOODSKLBTX,84,80,4,5%
12-01-2015,66870,PR45260CRESBUTEA,53,52,1,2%
23-08-2016,199,PARTS,35,93,-58,-166%
19-10-2016,74360,IRIS15AMDBTX,41,1,40,98%
21-07-2016,57497,GOLIADMLK14CTOE,36,88,-52,-144%
23-06-2016,84009,PR47686BVRCRK12,86,91,-5,-6%
24-06-2017,199,PARTS,71,25,46,65%
08-06-2017,57514,HOUSTON12CTOE,53,89,-36,-68%
06-10-2017,62854,PARKCITY14CTO,21,6,15,71%
05-05-2015,59515,BELMONTBTX,26,25,1,4%
07-05-2015,59384,IRIS15BDWBTX,54,54,0,0%
04-02-2016,57514,HOUSTON12CTOE,68,1,67,99%
25-05-2017,59515,BELMONTBTX,1,14,-13,-1300%
11-09-2015,59384,IRIS15BDWBTX,55,57,-2,-4%
23-08-2016,64250,JAYTONSECUREBTX,46,95,-49,-107%
18-03-2015,57527,HOUSTON15CTO,32,36,-4,-13%
22-03-2016,60151,TULIP17SKLBTX,4,56,-52,-1300%
03-10-2015,199,PARTS,5,38,-33,-660%
16-12-2017,52332,SALADO14BTX,49,65,-16,-33%
14-09-2015,60812,VENENOBTX,1,6,-5,-500%
12-12-2017,60150,TULIP15SKLBTX,8,76,-68,-850%
07-12-2015,70901,ROCKET11BSWBTX,31,19,12,39%
23-03-2017,63886,PANDORA15SKLBTX,26,88,-62,-238%
17-12-2017,60152,TULIP14AMDBTX,60,79,-19,-32%
12-07-2017,63886,PANDORA15SKLBTX,6,7,-1,-17%
14-09-2015,52370,SALADO 14,65,88,-23,-35%
13-12-2016,199,PARTS,53,47,6,11%
12-09-2017,62907,BEAVERCREEK14BTX,72,73,-1,-1%
06-03-2016,199,PARTS,83,33,50,60%
12-05-2017,62853,PARKCITY14BTX,25,87,-62,-248%
16-09-2016,60151,TULIP17SKLBTX,9,1,8,89%
10-03-2017,199,PARTS,70,56,14,20%
10-04-2017,61590,DINO2BTX,37,60,-23,-62%
23-12-2017,60153,TULIP15AMDBTX,10,78,-68,-680%
30-11-2017,199,PARTS,55,90,-35,-64%
04-09-2017,60705,VANGOGH15BDWBTX,55,21,34,62%
12-05-2017,60150,TULIP15SKLBTX,51,96,-45,-88%
30-07-2016,62853,PARKCITY14BTX,3,12,-9,-300%
26-01-2015,60150,TULIP15SKLBTX,47,69,-22,-47%
28-05-2016,63398,ECHO 17 MLK BTX,11,39,-28,-255%
30-03-2017,63886,PANDORA15SKLBTX,47,26,21,45%
05-06-2017,61590,DINO2BTX,19,39,-20,-105%
25-04-2016,56746,MARBLE FALLS15BTX,44,85,-41,-93%
20-10-2017,60151,TULIP17SKLBTX,34,57,-23,-68%
06-02-2017,79128,PR33444CRESBUTTE,44,3,41,93%
09-11-2015,199,PARTS,84,58,26,31%
20-08-2015,56745,MARBLE FALLS15CTO,42,4,38,90%
18-02-2016,60153,TULIP15AMDBTX,44,67,-23,-52%
01-09-2015,199,PARTS,31,27,4,13%
24-02-2017,56744,MARBLE FALLS14BTX,67,20,47,70%
30-11-2016,62850,PARKCITY12BTX,56,65,-9,-16%
05-07-2016,57495,GOLIADMLK12CTOE,99,2,97,98%
16-09-2017,199,PARTS,64,8,56,88%
29-06-2016,56744,MARBLE FALLS14BTX,61,65,-4,-7%
03-07-2017,61590,DINO2BTX,96,84,12,13%
03-05-2017,61590,DINO2BTX,12,28,-16,-133%
24-07-2015,56745,MARBLE FALLS15CTO,36,44,-8,-22%
11-05-2017,57499,GOLIADMLK14BTXE,6,45,-39,-650%
18-04-2016,61590,DINO2BTX,16,57,-41,-256%
07-08-2017,62854,PARKCITY14CTO,59,2,57,97%
09-10-2016,55728,CEDAR15BDWBTX,18,61,-43,-239%
18-08-2015,60150,TULIP15SKLBTX,22,9,13,59%
12-02-2017,199,PARTS,91,74,17,19%
03-08-2016,60148,TULIP17BDWBTX,82,36,46,56%
23-05-2016,62853,PARKCITY14BTX,4,60,-56,-1400%
08-05-2017,36029,SLINKY,54,76,-22,-41%
18-01-2016,199,PARTS,85,9,76,89%
28-07-2015,57496,GOLIADMLK12TAAE,88,87,1,1%
13-10-2016,58165,ECHO 15 CTO,7,55,-48,-686%
08-01-2015,56744,MARBLE FALLS14BTX,36,53,-17,-47%
23-01-2017,62879,LOVELAND15BBTX,77,10,67,87%
21-05-2016,63886,PANDORA15SKLBTX,53,100,-47,-89%
14-11-2015,57499,GOLIADMLK14BTXE,22,33,-11,-50%
15-10-2016,62907,BEAVERCREEK14BTX,57,56,1,2%
30-12-2015,57495,GOLIADMLK12CTOE,44,12,32,73%
19-12-2015,199,PARTS,51,8,43,84%
09-08-2016,79977,PR52856ERIKSNATG,3,100,-97,-3233%
04-08-2015,55727,CEDAR14BDWBTX,60,89,-29,-48%
04-04-2017,62595,PR37803GOLIAD12,72,28,44,61%
03-07-2015,56744,MARBLE FALLS14BTX,45,35,10,22%
09-05-2017,63256,COTTONWOODSKLBTX,2,12,-10,-500%
02-04-2017,199,PARTS,4,13,-9,-225%
25-04-2016,60150,TULIP15SKLBTX,88,25,63,72%
13-01-2016,62853,PARKCITY14BTX,87,68,19,22%
23-03-2017,60150,TULIP15SKLBTX,84,32,52,62%
30-01-2016,63886,PANDORA15SKLBTX,69,68,1,1%
06-11-2017,57616,CRESTED BUTTEBTX,31,88,-57,-184%
04-01-2017,53291,DIESEL 15,87,27,60,69%
21-07-2016,63399,ECHO 17 MLK CTO,23,81,-58,-252%
14-04-2017,59384,IRIS15BDWBTX,25,87,-62,-248%
15-02-2015,59379,IRIS14BSWBTX,55,71,-16,-29%
12-09-2016,74360,IRIS15AMDBTX,71,23,48,68%
24-09-2015,57515,HOUSTON12CTO,100,25,75,75%
05-05-2017,57499,GOLIADMLK14BTXE,33,8,25,76%
16-08-2015,199,PARTS,41,81,-40,-98%
18-11-2017,62850,PARKCITY12BTX,86,28,58,67%
29-03-2015,62853,PARKCITY14BTX,56,87,-31,-55%
22-02-2017,60705,VANGOGH15BDWBTX,48,11,37,77%
28-09-2016,60150,TULIP15SKLBTX,86,72,14,16%
24-10-2017,63274,MAPLE14SKLBTX,52,59,-7,-13%
01-07-2016,62853,PARKCITY14BTX,12,1,11,92%
09-03-2016,199,PARTS,37,82,-45,-122%
04-09-2015,63256,COTTONWOODSKLBTX,97,28,69,71%
03-02-2015,199,PARTS,9,32,-23,-256%
20-12-2015,59383,IRIS15BSWBTX,69,58,11,16%
16-10-2015,62853,PARKCITY14BTX,73,76,-3,-4%
13-12-2017,63256,COTTONWOODSKLBTX,14,39,-25,-179%
06-12-2016,55727,CEDAR14BDWBTX,56,15,41,73%
04-01-2015,199,PARTS,87,3,84,97%
25-05-2017,60146,TULIP14BDWBTX,5,72,-67,-1340%
20-08-2017,62889,LOVELAND15FBBTX,16,79,-63,-394%
12-09-2016,53292,DIESEL 17,36,50,-14,-39%
25-05-2017,62856,PARKCITY15BTX,70,31,39,56%
28-02-2015,57513,HOUSTON12BTX,29,24,5,17%
28-01-2016,52371,SALADO 15,45,63,-18,-40%
09-02-2016,60150,TULIP15SKLBTX,17,41,-24,-141%
17-01-2017,199,PARTS,61,72,-11,-18%
24-01-2017,199,PARTS,80,50,30,38%
20-12-2017,61339,MIRAMAR 15,16,78,-62,-388%
28-07-2017,63256,COTTONWOODSKLBTX,7,37,-30,-429%
29-05-2017,62883,LOVELAND15BCTO,73,60,13,18%
25-12-2016,57515,HOUSTON12CTO,91,89,2,2%
25-08-2017,63886,PANDORA15SKLBTX,67,61,6,9%
01-03-2017,57616,CRESTED BUTTEBTX,57,84,-27,-47%
13-01-2016,199,PARTS,42,95,-53,-126%
06-08-2017,62850,PARKCITY12BTX,38,24,14,37%
26-05-2016,57495,GOLIADMLK12CTOE,68,53,15,22%
06-10-2016,36029,SLINKY,44,47,-3,-7%
27-10-2015,61333,BERLINETTA P,37,46,-9,-24%
03-05-2015,63256,COTTONWOODSKLBTX,9,86,-77,-856%
16-11-2017,69925,CELTICCTO,30,82,-52,-173%
08-05-2016,60146,TULIP14BDWBTX,99,76,23,23%
30-09-2017,199,PARTS,81,71,10,12%
23-07-2017,62883,LOVELAND15BCTO,65,10,55,85%
08-01-2015,55727,CEDAR14BDWBTX,49,75,-26,-53%
18-03-2017,54984,ROUND ROCKBTX,41,50,-9,-22%
26-03-2015,57495,GOLIADMLK12CTOE,51,8,43,84%
22-03-2017,74360,IRIS15AMDBTX,28,11,17,61%
25-05-2016,68337,ROUND ROCKMLKBTX,98,100,-2,-2%
29-12-2016,62856,PARKCITY15BTX,65,10,55,85%
08-05-2017,59384,IRIS15BDWBTX,24,26,-2,-8%
12-07-2016,63256,COTTONWOODSKLBTX,68,49,19,28%
27-11-2016,81457,PR46978LOVELNB14,93,70,23,25%
06-11-2017,63256,COTTONWOODSKLBTX,80,77,3,4%
13-12-2016,79320,PR52497DIESEL17,36,37,-1,-3%
31-01-2015,63256,COTTONWOODSKLBTX,61,45,16,26%
05-05-2017,60150,TULIP15SKLBTX,8,60,-52,-650%
17-07-2017,63256,COTTONWOODSKLBTX,25,75,-50,-200%
07-05-2016,52371,SALADO 15,26,82,-56,-215%
03-10-2016,65308,BLACKWELLT4BTX,84,91,-7,-8%
25-02-2016,60146,TULIP14BDWBTX,46,89,-43,-93%
26-02-2015,59379,IRIS14BSWBTX,9,75,-66,-733%
28-10-2015,56553,BRADLEYBDWBTX,72,80,-8,-11%
22-01-2016,60150,TULIP15SKLBTX,24,94,-70,-292%
21-08-2017,62856,PARKCITY15BTX,28,32,-4,-14%
06-11-2016,57519,HOUSTON14BTX,68,63,5,7%
04-12-2017,64248,JAYTONBTX,28,53,-25,-89%
07-03-2017,57499,GOLIADMLK14BTXE,32,50,-18,-56%
20-08-2015,62856,PARKCITY15BTX,77,69,8,10%
31-08-2017,60146,TULIP14BDWBTX,58,67,-9,-16%
26-01-2015,64248,JAYTONBTX,14,68,-54,-386%
21-07-2015,63395,ECHO 13 MLK CTO,33,32,1,3%
05-09-2017,63034,MIRAMAR15TAA1,38,54,-16,-42%
02-12-2016,63256,COTTONWOODSKLBTX,21,49,-28,-133%
21-11-2015,60150,TULIP15SKLBTX,73,19,54,74%
25-06-2017,57499,GOLIADMLK14BTXE,8,79,-71,-888%
10-03-2015,68337,ROUND ROCKMLKBTX,1,96,-95,-9500%
04-06-2016,64248,JAYTONBTX,83,79,4,5%
14-01-2016,62870,PARKCITY12TAA1,23,90,-67,-291%
04-01-2017,57497,GOLIADMLK14CTOE,77,1,76,99%
28-11-2016,57379,JEFFERSONBTX,86,43,43,50%
12-02-2017,73125,PR49097GOL12MLKA,35,20,15,43%
11-10-2016,199,PARTS,28,56,-28,-100%
20-09-2017,62856,PARKCITY15BTX,74,63,11,15%
09-09-2017,199,PARTS,72,45,27,38%
23-05-2015,199,PARTS,32,32,0,0%
25-01-2016,63256,COTTONWOODSKLBTX,49,76,-27,-55%
09-07-2015,57191,ERIKSSON14CTO,53,96,-43,-81%
24-08-2016,57499,GOLIADMLK14BTXE,14,3,11,79%
22-07-2015,57514,HOUSTON12CTOE,30,32,-2,-7%
01-05-2016,199,PARTS,24,16,8,33%
13-08-2017,65308,BLACKWELLT4BTX,100,35,65,65%
06-06-2017,57379,JEFFERSONBTX,74,45,29,39%
24-08-2017,60148,TULIP17BDWBTX,65,61,4,6%
19-05-2015,56744,MARBLE FALLS14BTX,59,48,11,19%
15-03-2017,61590,DINO2BTX,42,52,-10,-24%
09-11-2016,57499,GOLIADMLK14BTXE,69,97,-28,-41%
04-03-2017,54142,TESTAROSSA P,73,8,65,89%
18-07-2015,56743,MARBLE FALLS14CTO,52,89,-37,-71%
08-06-2017,57519,HOUSTON14BTX,77,72,5,6%
29-10-2017,199,PARTS,65,65,0,0%
22-11-2017,57499,GOLIADMLK14BTXE,20,70,-50,-250%
01-11-2015,473,NON_TIED_PERIPHERALS,29,95,-66,-228%
21-05-2016,57283,COTTONWOODBDWBTX,100,54,46,46%
15-08-2016,57499,GOLIADMLK14BTXE,91,57,34,37%
18-05-2016,59515,BELMONTBTX,69,19,50,72%
02-10-2017,57499,GOLIADMLK14BTXE,85,35,50,59%
18-07-2015,57379,JEFFERSONBTX,53,12,41,77%
20-10-2015,57499,GOLIADMLK14BTXE,23,67,-44,-191%
08-08-2015,57379,JEFFERSONBTX,83,31,52,63%
31-01-2016,199,PARTS,9,49,-40,-444%
21-07-2015,60150,TULIP15SKLBTX,70,66,4,6%
04-10-2017,62882,LOVELAND14SCTO,20,4,16,80%
16-06-2016,63039,PARKCITY-P15CTO,39,64,-25,-64%
20-06-2015,62856,PARKCITY15BTX,83,73,10,12%
18-07-2017,60150,TULIP15SKLBTX,88,94,-6,-7%
20-06-2017,57499,GOLIADMLK14BTXE,81,61,20,25%
09-10-2015,57499,GOLIADMLK14BTXE,65,10,55,85%
21-08-2017,57379,JEFFERSONBTX,41,54,-13,-32%
02-05-2016,57521,HOUSTON14CTO,82,34,48,59%
01-07-2017,473,NON_TIED_PERIPHERALS,81,26,55,68%
07-07-2016,57379,JEFFERSONBTX,100,7,93,93%
24-10-2016,57379,JEFFERSONBTX,4,28,-24,-600%
23-01-2015,57499,GOLIADMLK14BTXE,34,4,30,88%
06-04-2016,62884,LOVELAND15SBTX,87,34,53,61%
10-07-2015,63886,PANDORA15SKLBTX,94,80,14,15%
13-04-2016,63256,COTTONWOODSKLBTX,95,32,63,66%
23-08-2016,62882,LOVELAND14SCTO,56,21,35,63%
22-05-2015,59379,IRIS14BSWBTX,71,53,18,25%
06-06-2016,57616,CRESTED BUTTEBTX,99,31,68,69%
10-12-2015,57499,GOLIADMLK14BTXE,17,2,15,88%
15-07-2016,56160,MAGELLAN14CTO1,69,44,25,36%
11-03-2017,63256,COTTONWOODSKLBTX,100,15,85,85%
04-03-2015,60150,TULIP15SKLBTX,83,88,-5,-6%
06-11-2015,57499,GOLIADMLK14BTXE,74,81,-7,-9%
25-08-2015,62853,PARKCITY14BTX,20,98,-78,-390%
22-10-2016,80004,PR40466BERLINEA,97,5,92,95%
17-11-2017,62853,PARKCITY14BTX,23,88,-65,-283%
02-11-2017,36029,SLINKY,20,61,-41,-205%
05-08-2016,57191,ERIKSSON14CTO,93,24,69,74%
25-09-2017,61590,DINO2BTX,48,8,40,83%
14-12-2015,62853,PARKCITY14BTX,6,55,-49,-817%
15-07-2016,59794,EAGLEPEAKBTX,39,3,36,92%
04-12-2016,63256,COTTONWOODSKLBTX,10,40,-30,-300%
01-07-2017,57616,CRESTED BUTTEBTX,3,59,-56,-1867%
03-11-2017,199,PARTS,48,61,-13,-27%
17-07-2016,62856,PARKCITY15BTX,48,92,-44,-92%
16-12-2016,57499,GOLIADMLK14BTXE,62,63,-1,-2%
31-08-2016,62857,PARKCITY15CTO,96,95,1,1%
09-06-2015,63256,COTTONWOODSKLBTX,46,75,-29,-63%
09-08-2016,59383,IRIS15BSWBTX,46,81,-35,-76%
12-01-2015,63274,MAPLE14SKLBTX,56,75,-19,-34%
19-11-2016,199,PARTS,57,46,11,19%
28-02-2016,74360,IRIS15AMDBTX,83,9,74,89%
17-02-2017,62856,PARKCITY15BTX,30,5,25,83%
22-08-2015,59384,IRIS15BDWBTX,5,54,-49,-980%
14-12-2015,62853,PARKCITY14BTX,30,5,25,83%
24-07-2015,57616,CRESTED BUTTEBTX,84,77,7,8%
19-06-2015,60150,TULIP15SKLBTX,38,53,-15,-39%
02-04-2015,57616,CRESTED BUTTEBTX,55,73,-18,-33%
07-11-2017,60150,TULIP15SKLBTX,1,72,-71,-7100%
25-05-2015,57616,CRESTED BUTTEBTX,62,18,44,71%
30-06-2015,61339,MIRAMAR 15,94,67,27,29%
03-12-2016,199,PARTS,14,93,-79,-564%
20-01-2017,62880,LOVELAND15SCTO,83,52,31,37%
18-08-2015,62856,PARKCITY15BTX,71,88,-17,-24%
11-07-2016,199,PARTS,94,80,14,15%
30-03-2017,57495,GOLIADMLK12CTOE,10,40,-30,-300%
17-01-2015,57519,HOUSTON14BTX,25,44,-19,-76%
19-06-2016,79323,PR52541DIESEL17,69,75,-6,-9%
28-09-2016,62856,PARKCITY15BTX,19,46,-27,-142%
18-07-2015,73137,PR49109MAGELLXFR,16,88,-72,-450%
20-03-2016,57495,GOLIADMLK12CTOE,86,92,-6,-7%
04-07-2016,59383,IRIS15BSWBTX,90,3,87,97%
07-06-2016,473,NON_TIED_PERIPHERALS,58,8,50,86%
05-01-2017,61590,DINO2BTX,13,72,-59,-454%
12-10-2016,62853,PARKCITY14BTX,15,32,-17,-113%
26-06-2016,62856,PARKCITY15BTX,58,86,-28,-48%
16-09-2017,59384,IRIS15BDWBTX,80,46,34,43%
25-06-2017,199,PARTS,39,92,-53,-136%
20-02-2015,62856,PARKCITY15BTX,6,4,2,33%
22-01-2015,61590,DINO2BTX,97,42,55,57%
05-01-2016,199,PARTS,10,4,6,60%
14-03-2016,53779,LATITUDE OAK15,93,75,18,19%
05-02-2016,63256,COTTONWOODSKLBTX,21,60,-39,-186%
03-03-2017,68337,ROUND ROCKMLKBTX,79,69,10,13%
19-02-2016,57521,HOUSTON14CTO,96,49,47,49%
04-11-2017,54142,TESTAROSSA P,98,15,83,85%
11-07-2015,199,PARTS,57,56,1,2%
19-12-2015,62853,PARKCITY14BTX,46,70,-24,-52%
31-08-2017,59384,IRIS15BDWBTX,46,14,32,70%
30-01-2017,62853,PARKCITY14BTX,95,27,68,72%
04-03-2015,63256,COTTONWOODSKLBTX,13,53,-40,-308%
06-07-2015,61590,DINO2BTX,15,89,-74,-493%
15-09-2015,55727,CEDAR14BDWBTX,63,22,41,65%
05-03-2017,61590,DINO2BTX,24,7,17,71%
08-06-2017,74496,PR49960LIVNGSTON,97,50,47,48%
30-05-2016,62856,PARKCITY15BTX,49,75,-26,-53%
28-07-2016,60151,TULIP17SKLBTX,5,93,-88,-1760%
25-11-2016,57527,HOUSTON15CTO,57,19,38,67%
30-04-2015,60150,TULIP15SKLBTX,95,38,57,60%
24-02-2017,59384,IRIS15BDWBTX,12,60,-48,-400%
04-07-2016,62881,LOVELAND14SBTX,82,10,72,88%
11-09-2016,62856,PARKCITY15BTX,24,15,9,38%
02-03-2017,57513,HOUSTON12BTX,21,69,-48,-229%
13-06-2016,199,PARTS,89,76,13,15%
22-11-2017,63044,PARKCITYP15CTO,79,51,28,35%
13-11-2015,57527,HOUSTON15CTO,6,83,-77,-1283%
07-04-2016,60150,TULIP15SKLBTX,7,47,-40,-571%
21-03-2017,57513,HOUSTON12BTX,76,42,34,45%
11-01-2015,62853,PARKCITY14BTX,25,72,-47,-188%
28-08-2015,199,PARTS,36,89,-53,-147%
16-01-2016,61339,MIRAMAR 15,22,37,-15,-68%
01-07-2015,57513,HOUSTON12BTX,42,82,-40,-95%
11-06-2015,61590,DINO2BTX,87,70,17,20%
04-03-2016,64250,JAYTONSECUREBTX,93,42,51,55%
25-07-2017,57513,HOUSTON12BTX,89,90,-1,-1%
25-06-2017,61590,DINO2BTX,53,42,11,21%
19-05-2016,57527,HOUSTON15CTO,94,60,34,36%
16-02-2017,61590,DINO2BTX,71,63,8,11%
24-03-2015,61590,DINO2BTX,14,33,-19,-136%
20-10-2017,61590,DINO2BTX,49,88,-39,-80%
15-11-2016,61590,DINO2BTX,77,50,27,35%
06-08-2017,61590,DINO2BTX,92,68,24,26%
06-06-2017,62856,PARKCITY15BTX,95,92,3,3%
03-03-2016,61590,DINO2BTX,51,81,-30,-59%
29-08-2016,64250,JAYTONSECUREBTX,33,34,-1,-3%
16-10-2016,68338,ROUND ROCKMLKCTO,59,97,-38,-64%
21-10-2017,57497,GOLIADMLK14CTOE,84,92,-8,-10%
05-07-2016,61239,REDWOODMLKBSWBTX,19,37,-18,-95%
17-04-2015,68337,ROUND ROCKMLKBTX,15,43,-28,-187%
04-04-2017,61590,DINO2BTX,5,7,-2,-40%
05-06-2016,199,PARTS,31,18,13,42%
07-03-2016,68337,ROUND ROCKMLKBTX,4,62,-58,-1450%
09-10-2017,61590,DINO2BTX,92,10,82,89%
04-10-2016,73526,PR49236PLANOM,78,45,33,42%
19-09-2016,70901,ROCKET11BSWBTX,53,11,42,79%
09-04-2017,57494,GOLIADMLK12BTXE,49,85,-36,-73%
10-01-2016,199,PARTS,56,61,-5,-9%
17-05-2015,60150,TULIP15SKLBTX,18,8,10,56%
09-09-2017,62881,LOVELAND14SBTX,95,4,91,96%
04-05-2016,57513,HOUSTON12BTX,10,74,-64,-640%
10-01-2015,61590,DINO2BTX,3,2,1,33%
26-01-2016,61590,DINO2BTX,39,77,-38,-97%
03-10-2016,58167,ECHO 17 CTO,56,88,-32,-57%
21-10-2015,62877,LOVELAND14BBTX,34,5,29,85%
19-07-2017,62856,PARKCITY15BTX,99,6,93,94%
23-08-2015,62853,PARKCITY14BTX,41,49,-8,-20%
28-09-2017,55725,CEDAR15HSWBTX,20,18,2,10%
17-08-2015,62880,LOVELAND15SCTO,8,42,-34,-425%
06-05-2016,199,PARTS,40,84,-44,-110%
20-01-2017,60704,VANGOGH14BDWBTX,9,22,-13,-144%
26-08-2016,62853,PARKCITY14BTX,63,8,55,87%
07-04-2015,63397,ECHO 15 MLK CTO,76,53,23,30%
04-02-2016,61590,DINO2BTX,71,55,16,23%
02-09-2015,61333,BERLINETTA P,20,59,-39,-195%
12-09-2016,60151,TULIP17SKLBTX,54,22,32,59%
04-04-2017,199,PARTS,34,2,32,94%
29-06-2016,63394,ECHO 13 MLK BTX,84,88,-4,-5%
01-07-2016,62850,PARKCITY12BTX,49,3,46,94%
17-05-2015,62904,BEAVERCREEK12BTX,13,40,-27,-208%
22-03-2017,62904,BEAVERCREEK12BTX,8,27,-19,-238%
29-09-2015,57617,CRESTED BUTTECTO,93,60,33,35%
21-02-2017,62853,PARKCITY14BTX,14,90,-76,-543%
02-09-2016,62853,PARKCITY14BTX,64,59,5,8%
22-06-2016,55727,CEDAR14BDWBTX,100,25,75,75%
26-06-2017,57515,HOUSTON12CTO,81,18,63,78%
28-08-2017,59384,IRIS15BDWBTX,13,8,5,38%
10-08-2015,199,PARTS,43,14,29,67%
11-01-2016,57617,CRESTED BUTTECTO,67,43,24,36%
29-05-2017,57521,HOUSTON14CTO,44,83,-39,-89%
24-08-2015,62853,PARKCITY14BTX,53,86,-33,-62%
13-10-2016,57617,CRESTED BUTTECTO,9,15,-6,-67%
13-03-2016,63394,ECHO 13 MLK BTX,22,31,-9,-41%
13-05-2017,199,PARTS,79,76,3,4%
23-03-2016,78260,PR51810SALADO15,5,25,-20,-400%
18-05-2017,32575,BRUTUS,99,50,49,49%
20-07-2017,62853,PARKCITY14BTX,46,69,-23,-50%
04-02-2015,62856,PARKCITY15BTX,48,39,9,19%
25-10-2015,55725,CEDAR15HSWBTX,57,92,-35,-61%
09-02-2015,67623,MONET14SKLBTX,40,92,-52,-130%
08-09-2017,55725,CEDAR15HSWBTX,32,43,-11,-34%
19-11-2017,55727,CEDAR14BDWBTX,42,68,-26,-62%
27-03-2016,63394,ECHO 13 MLK BTX,65,12,53,82%
12-02-2017,64250,JAYTONSECUREBTX,43,16,27,63%
03-06-2017,59670,PLANOBCTO,28,83,-55,-196%
27-11-2016,62853,PARKCITY14BTX,1,70,-69,-6900%
04-11-2016,62853,PARKCITY14BTX,86,62,24,28%
12-08-2015,61590,DINO2BTX,74,62,12,16%
15-08-2016,199,PARTS,68,70,-2,-3%
30-06-2015,32575,BRUTUS,47,79,-32,-68%
07-10-2017,57513,HOUSTON12BTX,51,48,3,6%
11-02-2016,62853,PARKCITY14BTX,91,37,54,59%
22-05-2017,57497,GOLIADMLK14CTOE,57,88,-31,-54%
14-11-2017,59515,BELMONTBTX,36,78,-42,-117%
23-09-2015,199,PARTS,28,90,-62,-221%
09-09-2017,61590,DINO2BTX,41,33,8,20%
04-10-2017,199,PARTS,58,39,19,33%
10-06-2017,60151,TULIP17SKLBTX,38,48,-10,-26%
18-11-2017,63395,ECHO 13 MLK CTO,49,8,41,84%
07-10-2017,65308,BLACKWELLT4BTX,29,22,7,24%
29-10-2016,55725,CEDAR15HSWBTX,26,62,-36,-138%
05-02-2016,60707,VANGOGH15SKLBTX,75,99,-24,-32%
30-08-2015,62892,LOVELAND15FBCTO,49,28,21,43%
13-01-2015,62911,BEAVERCREEK12FCTO,66,12,54,82%
23-04-2016,63394,ECHO 13 MLK BTX,14,66,-52,-371%
01-01-2015,59670,PLANOBCTO,77,42,35,45%
22-12-2017,199,PARTS,34,83,-49,-144%
27-11-2016,62853,PARKCITY14BTX,15,36,-21,-140%
09-01-2015,53292,DIESEL 17,56,88,-32,-57%
25-02-2015,60707,VANGOGH15SKLBTX,22,41,-19,-86%
11-03-2015,64248,JAYTONBTX,91,64,27,30%
04-02-2016,57521,HOUSTON14CTO,57,51,6,11%
09-02-2017,52375,SALADO 14 CTO,8,69,-61,-763%
28-02-2016,57514,HOUSTON12CTOE,31,30,1,3%
25-11-2015,59381,IRIS14SKLBTX,87,24,63,72%
18-02-2016,74115,PR43578HOUSTON14,24,51,-27,-113%
14-07-2016,59860,SILVERTONBTX,7,90,-83,-1186%
01-03-2015,199,PARTS,79,16,63,80%
20-11-2017,70901,ROCKET11BSWBTX,45,72,-27,-60%
03-11-2016,57515,HOUSTON12CTO,45,46,-1,-2%
01-03-2015,62850,PARKCITY12BTX,88,89,-1,-1%
04-10-2015,62851,PARKCITY12CTO,56,6,50,89%
21-12-2016,64248,JAYTONBTX,6,1,5,83%
20-08-2017,199,PARTS,35,50,-15,-43%
27-06-2016,57529,HOUSTON15TAA,2,93,-91,-4550%
08-12-2017,59860,SILVERTONBTX,38,94,-56,-147%
01-03-2017,62904,BEAVERCREEK12BTX,65,96,-31,-48%
15-12-2017,57513,HOUSTON12BTX,86,10,76,88%
02-01-2016,64248,JAYTONBTX,26,60,-34,-131%
17-12-2015,62853,PARKCITY14BTX,37,17,20,54%
07-11-2016,67623,MONET14SKLBTX,36,98,-62,-172%
30-12-2016,62856,PARKCITY15BTX,64,41,23,36%
18-01-2017,67774,PR45801ERIKSNATG,19,48,-29,-153%
23-07-2016,61590,DINO2BTX,69,9,60,87%
04-07-2017,57513,HOUSTON12BTX,46,45,1,2%
23-10-2016,64248,JAYTONBTX,27,74,-47,-174%
11-06-2017,62854,PARKCITY14CTO,52,64,-12,-23%
18-02-2015,62881,LOVELAND14SBTX,85,45,40,47%
11-04-2017,67623,MONET14SKLBTX,91,87,4,4%
30-12-2016,199,PARTS,31,98,-67,-216%
26-05-2017,63095,MERIDIANBTX,42,8,34,81%
05-06-2016,57513,HOUSTON12BTX,94,76,18,19%
22-09-2016,62857,PARKCITY15CTO,90,16,74,82%
10-07-2015,62853,PARKCITY14BTX,97,33,64,66%
20-07-2016,199,PARTS,71,12,59,83%
04-05-2016,57495,GOLIADMLK12CTOE,33,72,-39,-118%
06-05-2015,57513,HOUSTON12BTX,42,62,-20,-48%
03-11-2017,60154,TULIP17AMDBTX,47,64,-17,-36%
14-07-2016,199,PARTS,59,9,50,85%
26-10-2016,64248,JAYTONBTX,44,81,-37,-84%
10-09-2016,62905,BEAVERCREEK12CTO,9,76,-67,-744%
18-12-2016,57379,JEFFERSONBTX,2,60,-58,-2900%
19-12-2017,60150,TULIP15SKLBTX,75,65,10,13%
20-02-2017,62856,PARKCITY15BTX,85,22,63,74%
03-10-2016,62856,PARKCITY15BTX,62,78,-16,-26%
22-06-2017,56745,MARBLE FALLS15CTO,51,80,-29,-57%
13-10-2017,56744,MARBLE FALLS14BTX,99,74,25,25%
26-11-2016,60146,TULIP14BDWBTX,69,100,-31,-45%
27-07-2016,69931,CELTICTAA1,49,61,-12,-24%
03-05-2017,60145,TULIP15BSWBTX,49,98,-49,-100%
05-01-2015,199,PARTS,65,92,-27,-42%
09-05-2016,57527,HOUSTON15CTO,23,52,-29,-126%
26-07-2016,59670,PLANOBCTO,84,67,17,20%
30-11-2016,199,PARTS,35,49,-14,-40%
22-01-2015,63397,ECHO 15 MLK CTO,74,7,67,91%
21-10-2016,62880,LOVELAND15SCTO,93,30,63,68%
20-11-2015,57515,HOUSTON12CTO,85,89,-4,-5%
23-01-2017,199,PARTS,78,51,27,35%
02-06-2016,72810,PR48900CRESBUTEO,16,73,-57,-356%
01-12-2017,57523,HOUSTON14TAA,27,93,-66,-244%
06-03-2017,62856,PARKCITY15BTX,6,85,-79,-1317%
08-09-2015,62854,PARKCITY14CTO,25,32,-7,-28%
19-09-2017,57637,FOXGLOVEBTX,92,99,-7,-8%
31-10-2015,60146,TULIP14BDWBTX,56,76,-20,-36%
13-04-2015,63886,PANDORA15SKLBTX,62,17,45,73%
22-06-2016,55725,CEDAR15HSWBTX,54,7,47,87%
05-01-2017,199,PARTS,68,48,20,29%
26-12-2016,56746,MARBLE FALLS15BTX,38,25,13,34%
26-01-2017,61590,DINO2BTX,30,70,-40,-133%
18-01-2015,57515,HOUSTON12CTO,37,21,16,43%
03-01-2016,61590,DINO2BTX,84,26,58,69%
28-01-2016,199,PARTS,99,47,52,53%
13-05-2017,61590,DINO2BTX,76,1,75,99%
08-03-2017,57521,HOUSTON14CTO,73,39,34,47%
08-01-2016,52370,SALADO 14,4,74,-70,-1750%
04-02-2015,52333,SALADO15BTX,95,26,69,73%
03-03-2017,66803,SOMERSETBTX,44,63,-19,-43%
06-09-2015,199,PARTS,58,41,17,29%
27-06-2017,53510,GOLIAD 12,22,37,-15,-68%
24-07-2017,59670,PLANOBCTO,30,9,21,70%
08-03-2016,56744,MARBLE FALLS14BTX,77,28,49,64%
26-10-2017,72809,PR48811CRESBUTEO,28,44,-16,-57%
02-01-2016,60150,TULIP15SKLBTX,98,88,10,10%
06-04-2015,61590,DINO2BTX,30,59,-29,-97%
06-10-2016,199,PARTS,3,78,-75,-2500%
07-06-2017,62907,BEAVERCREEK14BTX,100,38,62,62%
14-01-2016,63274,MAPLE14SKLBTX,27,82,-55,-204%
28-08-2017,61590,DINO2BTX,89,10,79,89%
06-02-2017,199,PARTS,42,93,-51,-121%
12-04-2016,473,NON_TIED_PERIPHERALS,51,7,44,86%
26-01-2015,61590,DINO2BTX,55,72,-17,-31%
21-12-2017,61590,DINO2BTX,56,60,-4,-7%
12-04-2017,62856,PARKCITY15BTX,100,21,79,79%
01-06-2016,199,PARTS,89,88,1,1%
31-10-2015,80791,PR53371PRKCTY14O,84,35,49,58%
13-11-2016,69930,CELTICCTO1,98,86,12,12%
04-03-2016,60146,TULIP14BDWBTX,33,65,-32,-97%
29-08-2016,57513,HOUSTON12BTX,58,47,11,19%
25-03-2015,62884,LOVELAND15SBTX,9,44,-35,-389%
21-01-2016,57494,GOLIADMLK12BTXE,85,28,57,67%
09-08-2015,61590,DINO2BTX,38,7,31,82%
09-06-2016,62857,PARKCITY15CTO,48,37,11,23%
15-03-2015,76551,PR32196HOUSTN14E,97,38,59,61%
10-03-2016,66803,SOMERSETBTX,36,8,28,78%
01-03-2017,56746,MARBLE FALLS15BTX,51,80,-29,-57%
04-04-2016,57513,HOUSTON12BTX,58,69,-11,-19%
11-11-2016,57521,HOUSTON14CTO,20,92,-72,-360%
19-03-2016,57521,HOUSTON14CTO,100,29,71,71%
23-04-2017,57521,HOUSTON14CTO,52,98,-46,-88%
17-10-2015,64250,JAYTONSECUREBTX,28,76,-48,-171%
01-01-2017,61339,MIRAMAR 15,69,69,0,0%
24-02-2015,57617,CRESTED BUTTECTO,96,57,39,41%
08-08-2016,57513,HOUSTON12BTX,94,56,38,40%
12-09-2017,57513,HOUSTON12BTX,72,100,-28,-39%
24-01-2016,61590,DINO2BTX,84,6,78,93%
23-08-2016,57513,HOUSTON12BTX,56,22,34,61%
28-08-2016,57513,HOUSTON12BTX,55,53,2,4%
25-10-2016,59381,IRIS14SKLBTX,42,8,34,81%
22-12-2015,199,PARTS,96,81,15,16%
02-01-2016,57513,HOUSTON12BTX,39,81,-42,-108%
07-02-2017,60146,TULIP14BDWBTX,27,38,-11,-41%
04-01-2016,60149,TULIP14SKLBTX,89,8,81,91%
15-10-2017,57513,HOUSTON12BTX,33,60,-27,-82%
10-01-2015,199,PARTS,32,95,-63,-197%
05-02-2017,199,PARTS,89,60,29,33%
08-12-2015,66803,SOMERSETBTX,26,46,-20,-77%
10-05-2015,63039,PARKCITY-P15CTO,20,15,5,25%
21-03-2017,199,PARTS,59,22,37,63%
19-05-2016,59383,IRIS15BSWBTX,54,74,-20,-37%
03-10-2017,69923,CELTICBTX,72,87,-15,-21%
19-02-2016,66803,SOMERSETBTX,82,46,36,44%
28-02-2015,60150,TULIP15SKLBTX,98,2,96,98%
20-09-2017,74132,PR49747LIVNGSTON,81,23,58,72%
02-12-2015,66803,SOMERSETBTX,32,36,-4,-13%
03-11-2015,62857,PARKCITY15CTO,77,48,29,38%
08-09-2016,62854,PARKCITY14CTO,4,62,-58,-1450%
25-06-2016,66803,SOMERSETBTX,54,87,-33,-61%
10-01-2017,57379,JEFFERSONBTX,42,87,-45,-107%
02-01-2017,62914,BEAVERCREEK14FCTO,83,99,-16,-19%
08-06-2017,62850,PARKCITY12BTX,5,64,-59,-1180%
23-01-2015,60812,VENENOBTX,51,34,17,33%
29-02-2016,60154,TULIP17AMDBTX,7,54,-47,-671%
12-09-2015,64248,JAYTONBTX,81,56,25,31%
19-04-2016,60149,TULIP14SKLBTX,83,53,30,36%
24-02-2015,62850,PARKCITY12BTX,78,93,-15,-19%
03-12-2015,57368,FIGTREECTO,59,88,-29,-49%
14-08-2017,63397,ECHO 15 MLK CTO,84,56,28,33%
02-01-2016,62881,LOVELAND14SBTX,11,43,-32,-291%
09-03-2017,62914,BEAVERCREEK14FCTO,74,71,3,4%
03-12-2016,60146,TULIP14BDWBTX,8,43,-35,-438%
20-10-2015,56744,MARBLE FALLS14BTX,61,40,21,34%
05-07-2016,57284,REDWOODHSWBTX,26,94,-68,-262%
03-12-2015,199,PARTS,19,41,-22,-116%
06-06-2015,199,PARTS,2,50,-48,-2400%
14-06-2016,64248,JAYTONBTX,92,80,12,13%
06-07-2017,59515,BELMONTBTX,61,17,44,72%
08-06-2017,60813,BERLINETTABTX,36,30,6,17%
25-08-2015,60154,TULIP17AMDBTX,77,15,62,81%
22-06-2016,76974,PR51319SALADO15,52,61,-9,-17%
16-06-2017,57637,FOXGLOVEBTX,33,44,-11,-33%
15-08-2017,55757,MAPLEM14BDWBTX,43,88,-45,-105%
12-06-2016,60813,BERLINETTABTX,84,25,59,70%
06-07-2016,63399,ECHO 17 MLK CTO,52,26,26,50%
10-09-2016,59515,BELMONTBTX,81,37,44,54%
12-05-2015,62886,LOVELAND14FBCTO,68,9,59,87%
10-06-2017,57513,HOUSTON12BTX,98,67,31,32%
01-05-2015,199,PARTS,48,52,-4,-8%
10-12-2016,32577,CLOVER,47,27,20,43%
21-07-2016,57497,GOLIADMLK14CTOE,11,38,-27,-245%
13-09-2015,70901,ROCKET11BSWBTX,88,47,41,47%
26-04-2016,80824,PR46702HOUSTON15,23,100,-77,-335%
20-07-2015,56153,COLUMBUS12CTO,92,89,3,3%
21-12-2017,57527,HOUSTON15CTO,51,69,-18,-35%
04-07-2017,55758,MAPLEM15BDWBTX,1,18,-17,-1700%
09-05-2015,60707,VANGOGH15SKLBTX,13,14,-1,-8%
18-07-2017,60150,TULIP15SKLBTX,51,76,-25,-49%
12-03-2016,62883,LOVELAND15BCTO,34,41,-7,-21%
20-09-2017,68338,ROUND ROCKMLKCTO,60,1,59,98%
04-07-2016,199,PARTS,82,31,51,62%
25-07-2016,62856,PARKCITY15BTX,43,3,40,93%
06-11-2017,62904,BEAVERCREEK12BTX,49,99,-50,-102%
03-11-2016,199,PARTS,97,90,7,7%
27-09-2015,56153,COLUMBUS12CTO,4,2,2,50%
24-03-2016,60705,VANGOGH15BDWBTX,73,61,12,16%
26-03-2017,53295,DIESEL15BTX,67,92,-25,-37%
18-11-2017,62856,PARKCITY15BTX,48,71,-23,-48%
06-04-2015,62908,BEAVERCREEK14CTO,45,81,-36,-80%
30-04-2016,55725,CEDAR15HSWBTX,64,32,32,50%
09-02-2017,60153,TULIP15AMDBTX,94,80,14,15%
21-08-2016,62880,LOVELAND15SCTO,47,87,-40,-85%
26-06-2017,62856,PARKCITY15BTX,94,28,66,70%
16-08-2015,82597,PR54614BOLDPEAK2,13,67,-54,-415%
11-12-2015,61949,LIVINGSTONECTO,46,29,17,37%
15-04-2016,60707,VANGOGH15SKLBTX,26,51,-25,-96%
14-09-2016,57617,CRESTED BUTTECTO,67,34,33,49%
14-12-2015,63256,COTTONWOODSKLBTX,55,5,50,91%
23-06-2017,68337,ROUND ROCKMLKBTX,86,84,2,2%
07-01-2015,62856,PARKCITY15BTX,15,32,-17,-113%
19-10-2016,57520,HOUSTON14CTOE,89,59,30,34%
04-05-2016,63256,COTTONWOODSKLBTX,34,20,14,41%
07-06-2015,62853,PARKCITY14BTX,100,51,49,49%
02-03-2017,69925,CELTICCTO,85,49,36,42%
23-10-2016,62856,PARKCITY15BTX,18,35,-17,-94%
24-05-2016,62853,PARKCITY14BTX,21,60,-39,-186%
27-04-2015,56743,MARBLE FALLS14CTO,54,56,-2,-4%
21-02-2015,52370,SALADO 14,34,84,-50,-147%
08-05-2016,62877,LOVELAND14BBTX,81,80,1,1%
15-11-2017,61590,DINO2BTX,98,40,58,59%
29-08-2016,63256,COTTONWOODSKLBTX,32,65,-33,-103%
05-12-2017,62880,LOVELAND15SCTO,82,8,74,90%
26-04-2015,60153,TULIP15AMDBTX,64,27,37,58%
27-08-2017,199,PARTS,22,80,-58,-264%
08-11-2015,473,NON_TIED_PERIPHERALS,90,81,9,10%
17-09-2017,62879,LOVELAND15BBTX,21,70,-49,-233%
02-09-2015,60813,BERLINETTABTX,5,77,-72,-1440%
22-03-2017,57521,HOUSTON14CTO,83,44,39,47%
15-10-2016,62853,PARKCITY14BTX,15,48,-33,-220%
10-04-2016,55724,CEDAR14HSWBTX,100,96,4,4%
04-09-2015,62856,PARKCITY15BTX,26,90,-64,-246%
01-05-2015,60705,VANGOGH15BDWBTX,28,96,-68,-243%
27-08-2016,64250,JAYTONSECUREBTX,75,39,36,48%
29-02-2016,199,PARTS,25,80,-55,-220%
23-05-2016,62856,PARKCITY15BTX,90,37,53,59%
18-07-2016,61590,DINO2BTX,58,62,-4,-7%
05-02-2015,62907,BEAVERCREEK14BTX,25,12,13,52%
06-05-2015,62890,LOVELAND15FSCTO,31,10,21,68%
24-12-2016,199,PARTS,38,6,32,84%
10-10-2015,60822,BOLDPEAK2BTX,18,97,-79,-439%
05-02-2015,62856,PARKCITY15BTX,20,6,14,70%
17-10-2016,62856,PARKCITY15BTX,72,88,-16,-22%
23-11-2016,80839,PR46659BOLDPEAK2,6,64,-58,-967%
12-06-2017,61590,DINO2BTX,3,80,-77,-2567%
12-12-2016,57527,HOUSTON15CTO,67,74,-7,-10%
11-07-2015,60705,VANGOGH15BDWBTX,50,5,45,90%
25-08-2017,62856,PARKCITY15BTX,51,52,-1,-2%
20-06-2017,60705,VANGOGH15BDWBTX,60,63,-3,-5%
07-07-2016,57495,GOLIADMLK12CTOE,94,73,21,22%
23-07-2016,59383,IRIS15BSWBTX,5,45,-40,-800%
08-09-2016,59383,IRIS15BSWBTX,79,19,60,76%
23-08-2015,57495,GOLIADMLK12CTOE,43,14,29,67%
01-10-2016,70521,PRHOUSTON14CTOE5,60,95,-35,-58%
26-07-2015,80279,PR46374HOUSTON14,72,38,34,47%
05-09-2016,62856,PARKCITY15BTX,13,15,-2,-15%
21-04-2016,62854,PARKCITY14CTO,48,38,10,21%
17-09-2017,473,NON_TIED_PERIPHERALS,85,2,83,98%
04-02-2015,63254,REDWOODBSKLBTX,35,81,-46,-131%
26-08-2017,60813,BERLINETTABTX,41,4,37,90%
18-06-2015,56745,MARBLE FALLS15CTO,9,95,-86,-956%
17-08-2016,57520,HOUSTON14CTOE,59,56,3,5%
14-02-2015,63251,BLACKWOODSKLBTX,49,32,17,35%
26-10-2015,61590,DINO2BTX,87,97,-10,-11%
11-01-2017,62853,PARKCITY14BTX,24,83,-59,-246%
26-07-2016,60147,TULIP15BDWBTX,87,11,76,87%
13-02-2015,63256,COTTONWOODSKLBTX,17,20,-3,-18%
19-07-2016,72777,PR48799JEFFERSON,34,3,31,91%
09-06-2015,60153,TULIP15AMDBTX,46,98,-52,-113%
09-01-2017,62876,PARKCITY15TAA1,33,44,-11,-33%
21-05-2016,62878,LOVELAND14BCTO,48,39,9,19%
11-03-2016,199,PARTS,92,31,61,66%
26-07-2015,60813,BERLINETTABTX,88,99,-11,-13%
04-03-2015,62856,PARKCITY15BTX,86,28,58,67%
17-03-2016,63397,ECHO 15 MLK CTO,79,65,14,18%
06-11-2017,62884,LOVELAND15SBTX,49,63,-14,-29%
18-08-2017,60813,BERLINETTABTX,49,36,13,27%
23-03-2017,60707,VANGOGH15SKLBTX,99,92,7,7%
26-11-2017,62882,LOVELAND14SCTO,74,6,68,92%
30-11-2015,62856,PARKCITY15BTX,95,98,-3,-3%
31-05-2015,199,PARTS,27,48,-21,-78%
22-05-2017,70901,ROCKET11BSWBTX,58,71,-13,-22%
10-03-2015,63399,ECHO 17 MLK CTO,32,72,-40,-125%
07-09-2015,62856,PARKCITY15BTX,73,100,-27,-37%
10-11-2017,199,PARTS,19,36,-17,-89%
01-07-2015,62856,PARKCITY15BTX,37,61,-24,-65%
11-12-2015,199,PARTS,87,36,51,59%
07-06-2017,60813,BERLINETTABTX,79,8,71,90%
23-06-2016,199,PARTS,93,11,82,88%
21-10-2015,199,PARTS,26,77,-51,-196%
17-10-2015,199,PARTS,76,19,57,75%
17-02-2015,473,NON_TIED_PERIPHERALS,17,90,-73,-429%
19-06-2017,62856,PARKCITY15BTX,35,20,15,43%
03-07-2016,62853,PARKCITY14BTX,2,78,-76,-3800%
02-07-2016,199,PARTS,47,18,29,62%
03-05-2017,60153,TULIP15AMDBTX,55,91,-36,-65%
22-12-2017,73771,PR49423GOL14MLKA,37,56,-19,-51%
30-08-2017,62856,PARKCITY15BTX,81,37,44,54%
22-08-2015,199,PARTS,45,47,-2,-4%
19-08-2016,61590,DINO2BTX,30,65,-35,-117%
30-07-2017,473,NON_TIED_PERIPHERALS,53,93,-40,-75%
05-11-2016,62884,LOVELAND15SBTX,45,2,43,96%
11-06-2015,64250,JAYTONSECUREBTX,32,4,28,88%
06-09-2015,60822,BOLDPEAK2BTX,92,42,50,54%
19-02-2016,59515,BELMONTBTX,83,22,61,73%
24-04-2015,62907,BEAVERCREEK14BTX,95,82,13,14%
06-09-2015,60146,TULIP14BDWBTX,25,51,-26,-104%
08-07-2015,57499,GOLIADMLK14BTXE,32,99,-67,-209%
11-01-2017,57379,JEFFERSONBTX,99,36,63,64%
03-04-2017,76958,PR51156HOUSTN14O,97,23,74,76%
03-08-2016,59861,SILVEROAKBTX,78,44,34,44%
18-12-2015,57499,GOLIADMLK14BTXE,84,72,12,14%
28-09-2015,62856,PARKCITY15BTX,79,11,68,86%
14-08-2015,60813,BERLINETTABTX,45,13,32,71%
01-07-2016,64250,JAYTONSECUREBTX,33,68,-35,-106%
29-04-2017,76974,PR51319SALADO15,3,91,-88,-2933%
19-10-2015,59381,IRIS14SKLBTX,60,52,8,13%
16-11-2017,62877,LOVELAND14BBTX,87,92,-5,-6%
29-01-2017,57513,HOUSTON12BTX,63,15,48,76%
10-07-2016,62881,LOVELAND14SBTX,34,7,27,79%
28-01-2016,59515,BELMONTBTX,56,6,50,89%
18-08-2017,85185,PR56333LVELND14B,71,99,-28,-39%
19-12-2017,199,PARTS,35,9,26,74%
10-10-2017,62856,PARKCITY15BTX,87,26,61,70%
10-02-2015,62856,PARKCITY15BTX,28,11,17,61%
29-08-2017,57513,HOUSTON12BTX,49,27,22,45%
13-10-2017,199,PARTS,56,84,-28,-50%
18-07-2016,59515,BELMONTBTX,2,70,-68,-3400%
30-06-2015,199,PARTS,95,85,10,11%
30-04-2016,61590,DINO2BTX,86,60,26,30%
21-11-2016,57379,JEFFERSONBTX,63,73,-10,-16%
06-04-2016,59515,BELMONTBTX,69,35,34,49%
21-10-2016,199,PARTS,47,79,-32,-68%
14-03-2016,62891,LOVELAND15FSBTX,69,93,-24,-35%
06-09-2016,62856,PARKCITY15BTX,86,33,53,62%
04-02-2016,62856,PARKCITY15BTX,49,23,26,53%
07-01-2016,62856,PARKCITY15BTX,89,37,52,58%
20-09-2015,59515,BELMONTBTX,19,59,-40,-211%
01-02-2015,62857,PARKCITY15CTO,25,80,-55,-220%
08-10-2015,57379,JEFFERSONBTX,100,94,6,6%
04-07-2017,57623,CRESTEDBUTTECTO1,14,18,-4,-29%
21-06-2015,62850,PARKCITY12BTX,6,87,-81,-1350%
03-07-2017,62856,PARKCITY15BTX,68,6,62,91%
12-04-2015,60153,TULIP15AMDBTX,29,91,-62,-214%
23-04-2016,62856,PARKCITY15BTX,83,50,33,40%
14-08-2015,62856,PARKCITY15BTX,70,85,-15,-21%
31-07-2015,62856,PARKCITY15BTX,41,69,-28,-68%
05-09-2017,59384,IRIS15BDWBTX,8,69,-61,-763%
18-01-2017,62877,LOVELAND14BBTX,5,35,-30,-600%
15-12-2015,62856,PARKCITY15BTX,37,54,-17,-46%
28-05-2015,62873,PARKCITY14TAA1,27,37,-10,-37%
30-05-2017,59383,IRIS15BSWBTX,89,5,84,94%
03-06-2016,57379,JEFFERSONBTX,60,83,-23,-38%
30-12-2015,75082,PR50093PLANOB,51,27,24,47%
04-07-2017,199,PARTS,58,55,3,5%
25-08-2017,70901,ROCKET11BSWBTX,43,16,27,63%
27-07-2015,75591,PR50530PLANOM,95,31,64,67%
01-11-2016,74493,PR49939SALADO14,38,96,-58,-153%
05-09-2017,199,PARTS,70,56,14,20%
01-06-2017,60148,TULIP17BDWBTX,58,30,28,48%
15-07-2017,57379,JEFFERSONBTX,21,9,12,57%
06-03-2017,57379,JEFFERSONBTX,31,37,-6,-19%
05-01-2017,60705,VANGOGH15BDWBTX,22,85,-63,-286%
22-07-2015,57515,HOUSTON12CTO,97,61,36,37%
26-08-2017,60153,TULIP15AMDBTX,32,12,20,63%
27-01-2017,60822,BOLDPEAK2BTX,96,58,38,40%
22-08-2017,62856,PARKCITY15BTX,53,74,-21,-40%
15-04-2015,199,PARTS,18,81,-63,-350%
04-04-2015,63394,ECHO 13 MLK BTX,62,77,-15,-24%
20-08-2017,57513,HOUSTON12BTX,22,99,-77,-350%
14-06-2015,60705,VANGOGH15BDWBTX,79,51,28,35%
24-10-2015,64250,JAYTONSECUREBTX,88,90,-2,-2%
27-01-2017,62856,PARKCITY15BTX,9,83,-74,-822%
24-06-2016,53291,DIESEL 15,73,71,2,3%
12-03-2016,57455,TITAN14MLKBDWBTX,70,72,-2,-3%
28-09-2017,57525,HOUSTON15BTX,58,66,-8,-14%
08-08-2017,62856,PARKCITY15BTX,1,85,-84,-8400%
06-10-2015,199,PARTS,95,23,72,76%
30-07-2017,57379,JEFFERSONBTX,90,94,-4,-4%
20-07-2016,59379,IRIS14BSWBTX,94,100,-6,-6%
10-04-2015,62904,BEAVERCREEK12BTX,41,86,-45,-110%
17-06-2016,55758,MAPLEM15BDWBTX,8,87,-79,-988%
23-07-2017,56745,MARBLE FALLS15CTO,28,52,-24,-86%
17-12-2017,199,PARTS,64,87,-23,-36%
06-08-2015,57379,JEFFERSONBTX,25,23,2,8%
13-06-2015,473,NON_TIED_PERIPHERALS,57,58,-1,-2%
03-03-2017,57513,HOUSTON12BTX,13,100,-87,-669%
03-11-2016,60146,TULIP14BDWBTX,62,26,36,58%
07-05-2016,57379,JEFFERSONBTX,98,16,82,84%
10-01-2015,64248,JAYTONBTX,12,29,-17,-142%
14-11-2016,78284,PR45535GOLI14MLK,96,56,40,42%
02-02-2017,53510,GOLIAD 12,27,7,20,74%
27-05-2016,66803,SOMERSETBTX,13,99,-86,-662%
14-12-2015,64248,JAYTONBTX,85,87,-2,-2%
24-07-2016,62856,PARKCITY15BTX,59,30,29,49%
09-02-2015,60148,TULIP17BDWBTX,85,23,62,73%
28-03-2016,57513,HOUSTON12BTX,67,56,11,16%
07-07-2016,57495,GOLIADMLK12CTOE,40,53,-13,-33%
20-08-2017,62878,LOVELAND14BCTO,75,27,48,64%
24-12-2017,62856,PARKCITY15BTX,65,2,63,97%
27-11-2015,62850,PARKCITY12BTX,5,13,-8,-160%
20-12-2016,57368,FIGTREECTO,9,86,-77,-856%
15-09-2016,56745,MARBLE FALLS15CTO,48,60,-12,-25%
31-08-2017,64248,JAYTONBTX,94,55,39,41%
09-12-2016,53542,ALPINE 15,23,71,-48,-209%
05-02-2017,62904,BEAVERCREEK12BTX,9,31,-22,-244%
29-01-2017,57513,HOUSTON12BTX,3,40,-37,-1233%
18-01-2015,60153,TULIP15AMDBTX,85,70,15,18%
28-03-2017,77473,PR32650HOUSTN15E,78,86,-8,-10%
06-11-2015,60153,TULIP15AMDBTX,22,60,-38,-173%
16-04-2017,57455,TITAN14MLKBDWBTX,5,46,-41,-820%
05-06-2016,199,PARTS,88,22,66,75%
13-01-2017,57499,GOLIADMLK14BTXE,86,95,-9,-10%
13-12-2017,60153,TULIP15AMDBTX,17,37,-20,-118%
25-11-2015,79103,PR52339HOUSTN14A,7,80,-73,-1043%
19-10-2016,57499,GOLIADMLK14BTXE,50,79,-29,-58%
01-03-2016,59383,IRIS15BSWBTX,28,93,-65,-232%
01-07-2017,60150,TULIP15SKLBTX,69,23,46,67%
01-10-2017,62856,PARKCITY15BTX,30,75,-45,-150%
16-11-2017,67786,PR45795PLANOM,34,10,24,71%
27-09-2015,60812,VENENOBTX,46,19,27,59%
17-05-2016,60148,TULIP17BDWBTX,13,13,0,0%
04-07-2016,73137,PR49109MAGELLXFR,43,76,-33,-77%
21-04-2017,199,PARTS,64,43,21,33%
15-07-2016,55727,CEDAR14BDWBTX,71,8,63,89%
16-06-2017,62873,PARKCITY14TAA1,78,1,77,99%
15-12-2016,75902,PR50642MARFALS14,77,77,0,0%
05-04-2016,57519,HOUSTON14BTX,13,66,-53,-408%
16-03-2016,84934,PR36373BOLDPEAK2,71,6,65,92%
29-10-2016,62856,PARKCITY15BTX,75,90,-15,-20%
07-01-2017,52370,SALADO 14,46,57,-11,-24%
29-08-2017,57494,GOLIADMLK12BTXE,9,88,-79,-878%
25-02-2017,69925,CELTICCTO,63,65,-2,-3%
23-06-2017,199,PARTS,1,69,-68,-6800%
30-09-2015,57494,GOLIADMLK12BTXE,8,55,-47,-588%
14-04-2017,57527,HOUSTON15CTO,89,30,59,66%
16-12-2016,60147,TULIP15BDWBTX,14,67,-53,-379%
06-05-2016,57499,GOLIADMLK14BTXE,43,82,-39,-91%
11-06-2017,57616,CRESTED BUTTEBTX,28,66,-38,-136%
09-10-2016,60153,TULIP15AMDBTX,4,6,-2,-50%
14-08-2017,60828,BOLDPEAK2CTO1,25,89,-64,-256%
05-11-2016,57379,JEFFERSONBTX,89,3,86,97%
10-02-2015,199,PARTS,12,49,-37,-308%
25-01-2017,61339,MIRAMAR 15,34,61,-27,-79%
22-04-2017,57624,CRESTEDBUTTETAA1,4,25,-21,-525%
14-04-2015,199,PARTS,71,86,-15,-21%
22-06-2015,199,PARTS,62,70,-8,-13%
30-10-2017,62856,PARKCITY15BTX,86,94,-8,-9%
19-04-2016,62882,LOVELAND14SCTO,69,50,19,28%
01-07-2016,62856,PARKCITY15BTX,91,12,79,87%
02-05-2015,57640,DINO13BTX,66,26,40,61%
12-07-2015,62892,LOVELAND15FBCTO,20,36,-16,-80%
27-03-2015,199,PARTS,88,82,6,7%
11-12-2015,60812,VENENOBTX,20,24,-4,-20%
28-08-2017,81248,PR53723HOUSTN14O,7,81,-74,-1057%
14-11-2016,57527,HOUSTON15CTO,73,58,15,21%
01-10-2015,63039,PARKCITY-P15CTO,94,51,43,46%
03-10-2017,60146,TULIP14BDWBTX,73,73,0,0%
08-10-2016,62850,PARKCITY12BTX,16,90,-74,-463%
01-03-2017,59860,SILVERTONBTX,34,2,32,94%
25-07-2017,60143,TULIP15BYTBTX,52,82,-30,-58%
05-06-2017,62856,PARKCITY15BTX,79,25,54,68%
12-09-2015,63095,MERIDIANBTX,53,77,-24,-45%
02-09-2015,73385,PR37413HOUSTON15,62,49,13,21%
02-08-2016,62853,PARKCITY14BTX,54,98,-44,-81%
02-08-2015,199,PARTS,10,59,-49,-490%
03-05-2017,57495,GOLIADMLK12CTOE,79,32,47,59%
07-11-2016,62856,PARKCITY15BTX,84,4,80,95%
07-08-2015,62883,LOVELAND15BCTO,20,99,-79,-395%
17-07-2015,62879,LOVELAND15BBTX,98,2,96,98%
04-11-2017,63886,PANDORA15SKLBTX,56,52,4,7%
01-03-2016,60153,TULIP15AMDBTX,76,52,24,32%
25-10-2017,57521,HOUSTON14CTO,59,87,-28,-47%
07-08-2017,55728,CEDAR15BDWBTX,14,89,-75,-536%
08-06-2015,60150,TULIP15SKLBTX,17,32,-15,-88%
02-04-2016,62904,BEAVERCREEK12BTX,45,3,42,93%
03-07-2015,68338,ROUND ROCKMLKCTO,28,71,-43,-154%
15-10-2017,199,PARTS,49,22,27,55%
09-03-2016,60154,TULIP17AMDBTX,77,12,65,84%
22-03-2017,60148,TULIP17BDWBTX,40,48,-8,-20%
23-03-2017,199,PARTS,63,12,51,81%
09-02-2017,62904,BEAVERCREEK12BTX,8,42,-34,-425%
17-03-2017,57379,JEFFERSONBTX,82,93,-11,-13%
12-01-2016,57521,HOUSTON14CTO,64,5,59,92%
30-01-2015,57640,DINO13BTX,6,79,-73,-1217%
22-12-2015,199,PARTS,70,98,-28,-40%
30-08-2017,60151,TULIP17SKLBTX,69,18,51,74%
27-11-2016,59384,IRIS15BDWBTX,4,42,-38,-950%
24-05-2016,60706,VANGOGH14SKLBTX,82,93,-11,-13%
01-10-2015,63253,REDWOODSKLBTX,14,73,-59,-421%
19-03-2017,63886,PANDORA15SKLBTX,61,64,-3,-5%
12-11-2017,64248,JAYTONBTX,33,65,-32,-97%
19-06-2017,199,PARTS,20,95,-75,-375%
23-06-2017,59860,SILVERTONBTX,55,12,43,78%
12-12-2015,199,PARTS,37,41,-4,-11%
01-07-2015,57640,DINO13BTX,15,75,-60,-400%
23-08-2015,56153,COLUMBUS12CTO,96,19,77,80%
28-07-2016,199,PARTS,61,35,26,43%
22-01-2017,60153,TULIP15AMDBTX,29,3,26,90%
09-04-2015,60153,TULIP15AMDBTX,48,4,44,92%
22-07-2015,199,PARTS,27,82,-55,-204%
08-11-2016,62907,BEAVERCREEK14BTX,50,50,0,0%
25-07-2016,52370,SALADO 14,23,75,-52,-226%
30-09-2016,84445,PR55807GO14MLKOE,77,68,9,12%
30-08-2016,63039,PARKCITY-P15CTO,73,14,59,81%
28-06-2017,67623,MONET14SKLBTX,38,29,9,24%
04-02-2016,62877,LOVELAND14BBTX,72,33,39,54%
24-11-2015,56153,COLUMBUS12CTO,87,74,13,15%
23-11-2016,63095,MERIDIANBTX,82,38,44,54%
14-05-2016,62907,BEAVERCREEK14BTX,100,69,31,31%
03-08-2016,60150,TULIP15SKLBTX,58,44,14,24%
02-03-2015,62907,BEAVERCREEK14BTX,78,84,-6,-8%
11-11-2017,63095,MERIDIANBTX,26,53,-27,-104%
14-01-2016,199,PARTS,89,74,15,17%
25-08-2017,60146,TULIP14BDWBTX,2,21,-19,-950%
01-08-2017,64250,JAYTONSECUREBTX,83,33,50,60%
02-10-2015,60153,TULIP15AMDBTX,25,13,12,48%
01-04-2017,49918,OAKM17IVBBTX,43,8,35,81%
08-05-2015,62857,PARKCITY15CTO,97,33,64,66%
19-08-2015,62907,BEAVERCREEK14BTX,46,84,-38,-83%
02-06-2017,57191,ERIKSSON14CTO,88,22,66,75%
12-10-2017,473,NON_TIED_PERIPHERALS,99,53,46,46%
30-05-2016,57499,GOLIADMLK14BTXE,47,21,26,55%
14-11-2016,62907,BEAVERCREEK14BTX,46,25,21,46%
23-05-2016,52371,SALADO 15,47,76,-29,-62%
26-05-2015,60151,TULIP17SKLBTX,84,96,-12,-14%
22-03-2015,199,PARTS,90,70,20,22%
07-04-2017,57499,GOLIADMLK14BTXE,71,33,38,54%
12-02-2015,62907,BEAVERCREEK14BTX,22,10,12,55%
25-08-2016,60150,TULIP15SKLBTX,57,80,-23,-40%
27-05-2015,62907,BEAVERCREEK14BTX,26,32,-6,-23%
27-04-2015,60151,TULIP17SKLBTX,18,9,9,50%
13-09-2016,62857,PARKCITY15CTO,6,88,-82,-1367%
09-07-2016,60153,TULIP15AMDBTX,90,97,-7,-8%
06-01-2015,60707,VANGOGH15SKLBTX,12,33,-21,-175%
28-09-2015,56745,MARBLE FALLS15CTO,3,97,-94,-3133%
26-08-2016,57616,CRESTED BUTTEBTX,52,27,25,48%
03-02-2015,60153,TULIP15AMDBTX,47,37,10,21%
11-03-2016,71137,PR47771DIESEL15,65,68,-3,-5%
13-07-2015,61341,MIRAMAR 17,50,37,13,26%
08-12-2015,199,PARTS,91,89,2,2%
06-07-2017,199,PARTS,57,87,-30,-53%
28-12-2017,62877,LOVELAND14BBTX,45,34,11,24%
22-08-2016,72825,PR48929HOUSTN14O,4,95,-91,-2275%
07-03-2016,62907,BEAVERCREEK14BTX,41,79,-38,-93%
21-11-2016,61590,DINO2BTX,17,15,2,12%
11-08-2017,60813,BERLINETTABTX,80,87,-7,-9%
08-10-2016,64248,JAYTONBTX,81,69,12,15%
18-10-2016,57497,GOLIADMLK14CTOE,87,57,30,34%
03-03-2017,62907,BEAVERCREEK14BTX,49,11,38,78%
26-04-2017,57521,HOUSTON14CTO,81,16,65,80%
11-01-2017,53850,DIESEL15CTO,91,16,75,82%
29-09-2015,57616,CRESTED BUTTEBTX,18,65,-47,-261%
01-03-2017,54983,ROUND ROCK,27,69,-42,-156%
12-01-2017,199,PARTS,20,10,10,50%
21-04-2017,62907,BEAVERCREEK14BTX,38,13,25,66%
03-03-2016,62907,BEAVERCREEK14BTX,41,39,2,5%
27-01-2015,62854,PARKCITY14CTO,52,53,-1,-2%
13-12-2015,199,PARTS,89,26,63,71%
14-05-2017,199,PARTS,49,42,7,14%
25-06-2016,57499,GOLIADMLK14BTXE,79,76,3,4%
25-02-2017,61239,REDWOODMLKBSWBTX,34,88,-54,-159%
08-06-2015,62907,BEAVERCREEK14BTX,19,55,-36,-189%
16-03-2016,57499,GOLIADMLK14BTXE,18,94,-76,-422%
17-05-2015,57499,GOLIADMLK14BTXE,14,24,-10,-71%
10-11-2016,62907,BEAVERCREEK14BTX,94,11,83,88%
02-04-2016,199,PARTS,52,51,1,2%
18-07-2015,62856,PARKCITY15BTX,30,29,1,3%
14-03-2016,68338,ROUND ROCKMLKCTO,47,37,10,21%
17-06-2016,57499,GOLIADMLK14BTXE,12,82,-70,-583%
10-10-2017,62907,BEAVERCREEK14BTX,96,100,-4,-4%
25-09-2015,57368,FIGTREECTO,63,37,26,41%
01-06-2015,61239,REDWOODMLKBSWBTX,64,71,-7,-11%
29-07-2016,62881,LOVELAND14SBTX,4,59,-55,-1375%
03-10-2016,60151,TULIP17SKLBTX,31,97,-66,-213%
22-06-2017,57499,GOLIADMLK14BTXE,7,92,-85,-1214%
26-02-2016,199,PARTS,82,78,4,5%
30-01-2017,57499,GOLIADMLK14BTXE,93,38,55,59%
06-03-2017,57499,GOLIADMLK14BTXE,53,68,-15,-28%
20-11-2016,78055,PR45485HOUSTON14,48,15,33,69%
28-10-2015,199,PARTS,92,43,49,53%
26-02-2015,57499,GOLIADMLK14BTXE,75,97,-22,-29%
25-12-2017,60151,TULIP17SKLBTX,7,87,-80,-1143%
03-04-2017,62907,BEAVERCREEK14BTX,42,6,36,86%
15-02-2017,57499,GOLIADMLK14BTXE,76,47,29,38%
01-12-2017,63886,PANDORA15SKLBTX,10,36,-26,-260%
13-12-2016,65308,BLACKWELLT4BTX,83,5,78,94%
28-12-2017,62907,BEAVERCREEK14BTX,23,39,-16,-70%
26-12-2017,61590,DINO2BTX,72,54,18,25%
21-10-2016,57616,CRESTED BUTTEBTX,72,64,8,11%
10-12-2016,199,PARTS,74,91,-17,-23%
31-12-2017,62907,BEAVERCREEK14BTX,22,100,-78,-355%
01-03-2017,61590,DINO2BTX,34,72,-38,-112%
27-07-2015,62907,BEAVERCREEK14BTX,9,41,-32,-356%
25-07-2016,62907,BEAVERCREEK14BTX,74,31,43,58%
15-02-2016,64248,JAYTONBTX,96,93,3,3%
31-05-2015,62907,BEAVERCREEK14BTX,38,34,4,11%
18-10-2016,60151,TULIP17SKLBTX,46,50,-4,-9%
29-10-2016,60151,TULIP17SKLBTX,81,54,27,33%
25-07-2015,54983,ROUND ROCK,70,100,-30,-43%
09-07-2015,64250,JAYTONSECUREBTX,81,8,73,90%
03-03-2015,60151,TULIP17SKLBTX,48,2,46,96%
11-06-2015,80792,PR53476PRKCTY14O,71,67,4,6%
10-09-2016,57190,ERIKSSON14BTX,85,20,65,76%
22-10-2016,62907,BEAVERCREEK14BTX,44,43,1,2%
17-05-2015,61590,DINO2BTX,3,64,-61,-2033%
31-03-2017,62881,LOVELAND14SBTX,15,74,-59,-393%
20-12-2015,60150,TULIP15SKLBTX,98,3,95,97%
15-03-2015,62851,PARKCITY12CTO,55,37,18,33%
08-06-2017,60143,TULIP15BYTBTX,32,22,10,31%
26-08-2016,59861,SILVEROAKBTX,80,88,-8,-10%
15-11-2015,85650,PR56466BOLDPEAK2,68,75,-7,-10%
04-05-2017,62851,PARKCITY12CTO,15,24,-9,-60%
27-03-2016,54983,ROUND ROCK,90,34,56,62%
10-07-2017,199,PARTS,55,7,48,87%
29-08-2016,60151,TULIP17SKLBTX,80,100,-20,-25%
28-03-2016,54142,TESTAROSSA P,52,47,5,10%
31-05-2015,63039,PARKCITY-P15CTO,78,64,14,18%
18-04-2017,68337,ROUND ROCKMLKBTX,89,30,59,66%
01-09-2015,53292,DIESEL 17,10,11,-1,-10%
23-10-2017,62907,BEAVERCREEK14BTX,72,48,24,33%
06-01-2017,64250,JAYTONSECUREBTX,48,13,35,73%
25-08-2016,57497,GOLIADMLK14CTOE,84,40,44,52%
04-11-2017,82543,PR41658BERLINEA,28,60,-32,-114%
17-08-2016,60705,VANGOGH15BDWBTX,20,3,17,85%
07-10-2016,60705,VANGOGH15BDWBTX,90,72,18,20%
22-01-2017,199,PARTS,9,44,-35,-389%
15-09-2015,79342,PR52607MAGELLXFR,31,1,30,97%
05-09-2016,57190,ERIKSSON14BTX,9,11,-2,-22%
20-04-2016,59861,SILVEROAKBTX,44,91,-47,-107%
26-04-2016,60151,TULIP17SKLBTX,96,4,92,96%
30-12-2016,68337,ROUND ROCKMLKBTX,29,31,-2,-7%
30-05-2017,62850,PARKCITY12BTX,40,98,-58,-145%
11-06-2016,61590,DINO2BTX,40,28,12,30%
02-04-2017,79128,PR33444CRESBUTTE,87,72,15,17%
17-04-2015,59668,PLANOMCTO,6,95,-89,-1483%
26-06-2015,57513,HOUSTON12BTX,3,19,-16,-533%
21-07-2015,61590,DINO2BTX,94,20,74,79%
28-08-2017,63253,REDWOODSKLBTX,64,83,-19,-30%
23-03-2017,61590,DINO2BTX,42,26,16,38%
03-06-2016,68337,ROUND ROCKMLKBTX,55,76,-21,-38%
09-06-2016,60150,TULIP15SKLBTX,74,59,15,20%
02-02-2015,63256,COTTONWOODSKLBTX,66,32,34,52%
18-02-2017,61590,DINO2BTX,40,92,-52,-130%
14-11-2017,60706,VANGOGH14SKLBTX,6,37,-31,-517%
05-10-2015,66803,SOMERSETBTX,38,31,7,18%
12-08-2015,68337,ROUND ROCKMLKBTX,17,85,-68,-400%
02-05-2015,82959,PR47602LOVELNS15,13,14,-1,-8%
24-09-2017,60147,TULIP15BDWBTX,65,76,-11,-17%
19-12-2017,66803,SOMERSETBTX,76,17,59,78%
05-09-2017,199,PARTS,70,92,-22,-31%
20-02-2017,60705,VANGOGH15BDWBTX,9,53,-44,-489%
21-08-2015,64248,JAYTONBTX,75,8,67,89%
23-08-2015,68337,ROUND ROCKMLKBTX,48,96,-48,-100%
11-08-2015,83543,PR55307SALADO14,78,72,6,8%
17-10-2016,68337,ROUND ROCKMLKBTX,74,45,29,39%
24-10-2015,57455,TITAN14MLKBDWBTX,28,81,-53,-189%
24-03-2016,57455,TITAN14MLKBDWBTX,39,90,-51,-131%
07-02-2015,56744,MARBLE FALLS14BTX,16,13,3,19%
21-05-2017,60150,TULIP15SKLBTX,38,3,35,92%
07-09-2015,60150,TULIP15SKLBTX,32,37,-5,-16%
21-03-2016,62877,LOVELAND14BBTX,89,64,25,28%
10-04-2016,56151,MAGELLAN14CTO,48,86,-38,-79%
22-12-2016,60147,TULIP15BDWBTX,44,67,-23,-52%
09-09-2015,60147,TULIP15BDWBTX,82,20,62,76%
05-05-2016,62879,LOVELAND15BBTX,68,30,38,56%
04-05-2017,62856,PARKCITY15BTX,36,7,29,81%
28-09-2015,199,PARTS,23,22,1,4%
25-05-2016,66803,SOMERSETBTX,47,73,-26,-55%
27-12-2017,56743,MARBLE FALLS14CTO,17,43,-26,-153%
14-06-2015,61590,DINO2BTX,40,54,-14,-35%
16-04-2017,56744,MARBLE FALLS14BTX,64,21,43,67%
09-11-2015,64248,JAYTONBTX,27,96,-69,-256%
29-05-2016,57455,TITAN14MLKBDWBTX,17,51,-34,-200%
27-09-2015,52333,SALADO15BTX,21,64,-43,-205%
04-07-2017,199,PARTS,91,66,25,27%
01-06-2017,57499,GOLIADMLK14BTXE,6,87,-81,-1350%
02-03-2016,59384,IRIS15BDWBTX,68,42,26,38%
19-04-2017,60150,TULIP15SKLBTX,95,95,0,0%
23-02-2015,60705,VANGOGH15BDWBTX,90,11,79,88%
16-12-2017,57191,ERIKSSON14CTO,36,93,-57,-158%
07-04-2016,74360,IRIS15AMDBTX,74,98,-24,-32%
18-05-2016,74360,IRIS15AMDBTX,86,97,-11,-13%
18-04-2015,68337,ROUND ROCKMLKBTX,13,12,1,8%
26-07-2015,62886,LOVELAND14FBCTO,5,53,-48,-960%
04-10-2016,61590,DINO2BTX,1,61,-60,-6000%
24-05-2016,65308,BLACKWELLT4BTX,59,32,27,46%
30-07-2017,62907,BEAVERCREEK14BTX,4,16,-12,-300%
31-12-2017,57455,TITAN14MLKBDWBTX,43,85,-42,-98%
01-05-2015,59382,IRIS15BYTBTX,41,23,18,44%
11-05-2016,60150,TULIP15SKLBTX,89,2,87,98%
19-12-2016,52356,SALADO15CTO1,24,79,-55,-229%
26-05-2016,60153,TULIP15AMDBTX,94,5,89,95%
28-02-2017,55727,CEDAR14BDWBTX,56,40,16,29%
20-01-2015,62880,LOVELAND15SCTO,38,68,-30,-79%
25-07-2015,62851,PARKCITY12CTO,89,43,46,52%
09-01-2017,60150,TULIP15SKLBTX,14,98,-84,-600%
10-10-2017,76973,PR51318SALADO15,84,94,-10,-12%
01-02-2017,66803,SOMERSETBTX,4,64,-60,-1500%
14-11-2016,63276,MAPLE15SKLBTX,13,52,-39,-300%
14-09-2015,60151,TULIP17SKLBTX,25,79,-54,-216%
16-06-2015,61590,DINO2BTX,18,63,-45,-250%
13-03-2015,59383,IRIS15BSWBTX,82,16,66,80%
05-08-2015,52511,GOLIAD12BTX,100,70,30,30%
20-11-2016,63255,COTTONWOODBSKLBTX,83,94,-11,-13%
21-10-2017,57455,TITAN14MLKBDWBTX,84,59,25,30%
06-08-2016,57455,TITAN14MLKBDWBTX,74,65,9,12%
17-11-2016,199,PARTS,88,79,9,10%
12-08-2015,60705,VANGOGH15BDWBTX,2,100,-98,-4900%
01-05-2016,199,PARTS,19,96,-77,-405%
31-03-2016,66803,SOMERSETBTX,12,53,-41,-342%
01-11-2015,199,PARTS,50,17,33,66%
30-01-2016,63256,COTTONWOODSKLBTX,4,31,-27,-675%
11-04-2016,62877,LOVELAND14BBTX,93,71,22,24%
02-02-2015,60147,TULIP15BDWBTX,74,56,18,24%
06-06-2017,57624,CRESTEDBUTTETAA1,63,21,42,67%
24-07-2016,60706,VANGOGH14SKLBTX,8,68,-60,-750%
04-07-2017,73929,DRAXBTX,19,13,6,32%
26-09-2017,199,PARTS,97,48,49,51%
19-03-2016,57623,CRESTEDBUTTECTO1,67,85,-18,-27%
08-05-2017,56517,REDWOODBTX,7,62,-55,-786%
23-05-2015,60153,TULIP15AMDBTX,46,45,1,2%
01-07-2017,66803,SOMERSETBTX,87,28,59,68%
10-08-2016,63255,COTTONWOODBSKLBTX,77,42,35,45%
04-08-2015,61590,DINO2BTX,24,28,-4,-17%
04-03-2016,56744,MARBLE FALLS14BTX,41,22,19,46%
16-02-2016,199,PARTS,97,5,92,95%
03-07-2015,63255,COTTONWOODBSKLBTX,85,58,27,32%
17-05-2016,72168,PR48340CRESBUTEA,83,40,43,52%
30-12-2016,62881,LOVELAND14SBTX,65,76,-11,-17%
10-03-2016,60147,TULIP15BDWBTX,34,51,-17,-50%
07-05-2016,57617,CRESTED BUTTECTO,95,86,9,9%
23-12-2016,59383,IRIS15BSWBTX,49,82,-33,-67%
01-11-2017,61239,REDWOODMLKBSWBTX,25,18,7,28%
20-08-2016,66803,SOMERSETBTX,69,35,34,49%
05-05-2017,61590,DINO2BTX,92,67,25,27%
06-03-2015,62905,BEAVERCREEK12CTO,83,52,31,37%
16-09-2015,63256,COTTONWOODSKLBTX,76,78,-2,-3%
26-04-2016,61590,DINO2BTX,80,76,4,5%
07-03-2017,56744,MARBLE FALLS14BTX,28,78,-50,-179%
16-04-2016,63256,COTTONWOODSKLBTX,74,19,55,74%
21-09-2015,60154,TULIP17AMDBTX,97,42,55,57%
08-12-2015,61590,DINO2BTX,3,36,-33,-1100%
04-06-2017,63256,COTTONWOODSKLBTX,50,100,-50,-100%
25-05-2015,70901,ROCKET11BSWBTX,98,71,27,28%
31-01-2015,63256,COTTONWOODSKLBTX,99,98,1,1%
15-03-2016,63255,COTTONWOODBSKLBTX,33,23,10,30%
19-10-2016,199,PARTS,61,96,-35,-57%
01-12-2015,60147,TULIP15BDWBTX,58,32,26,45%
19-10-2016,60153,TULIP15AMDBTX,45,33,12,27%
15-11-2015,61341,MIRAMAR 17,85,45,40,47%
29-08-2016,57525,HOUSTON15BTX,49,2,47,96%
13-05-2017,60153,TULIP15AMDBTX,15,16,-1,-7%
07-01-2015,60705,VANGOGH15BDWBTX,21,20,1,5%
03-06-2017,63095,MERIDIANBTX,53,56,-3,-6%
16-10-2016,81749,PR54079CRESBUTEA,39,11,28,72%
27-03-2015,79335,PR52499HOUSTN14O,6,66,-60,-1000%
23-03-2015,62857,PARKCITY15CTO,100,87,13,13%
29-05-2015,66803,SOMERSETBTX,12,78,-66,-550%
27-11-2015,60705,VANGOGH15BDWBTX,78,85,-7,-9%
04-03-2016,80595,PR46566BOLDPEAK2,11,61,-50,-455%
08-09-2016,59384,IRIS15BDWBTX,89,72,17,19%
24-09-2017,56151,MAGELLAN14CTO,14,68,-54,-386%
03-11-2015,60153,TULIP15AMDBTX,58,78,-20,-34%
15-06-2015,62880,LOVELAND15SCTO,70,83,-13,-19%
05-01-2017,60705,VANGOGH15BDWBTX,24,41,-17,-71%
02-07-2016,63886,PANDORA15SKLBTX,27,3,24,89%
08-06-2016,52370,SALADO 14,14,11,3,21%
12-12-2016,66803,SOMERSETBTX,91,48,43,47%
06-07-2015,55725,CEDAR15HSWBTX,23,85,-62,-270%
28-07-2016,63256,COTTONWOODSKLBTX,47,36,11,23%
08-06-2016,60705,VANGOGH15BDWBTX,78,72,6,8%
15-04-2017,57374,FIGTREETAA1,60,30,30,50%
31-08-2016,57495,GOLIADMLK12CTOE,65,82,-17,-26%
29-04-2017,60147,TULIP15BDWBTX,52,14,38,73%
01-05-2016,199,PARTS,86,89,-3,-3%
07-04-2016,199,PARTS,76,51,25,33%
20-06-2017,57527,HOUSTON15CTO,17,40,-23,-135%
19-02-2016,76276,PR50904MAGELLXFR,43,18,25,58%
17-06-2016,57379,JEFFERSONBTX,21,45,-24,-114%
02-03-2015,55724,CEDAR14HSWBTX,27,100,-73,-270%
27-07-2017,56151,MAGELLAN14CTO,72,54,18,25%
29-04-2015,78288,PR45541FIGTREE,17,69,-52,-306%
08-01-2016,59382,IRIS15BYTBTX,84,28,56,67%
19-06-2017,66803,SOMERSETBTX,4,29,-25,-625%
22-08-2017,56160,MAGELLAN14CTO1,79,19,60,76%
01-05-2017,199,PARTS,35,79,-44,-126%
13-11-2017,57379,JEFFERSONBTX,41,10,31,76%
26-11-2017,73764,PR49535GOL14MLKO,24,4,20,83%
08-07-2016,60147,TULIP15BDWBTX,29,3,26,90%
07-08-2015,81256,PR53866PRKCTY14O,23,33,-10,-43%
22-10-2015,57525,HOUSTON15BTX,78,33,45,58%
26-02-2015,60150,TULIP15SKLBTX,56,15,41,73%
02-05-2015,60705,VANGOGH15BDWBTX,56,21,35,63%
26-07-2016,63886,PANDORA15SKLBTX,82,22,60,73%
08-10-2015,59384,IRIS15BDWBTX,77,66,11,14%
14-07-2015,60704,VANGOGH14BDWBTX,49,40,9,18%
09-09-2016,61339,MIRAMAR 15,70,12,58,83%
06-01-2015,61590,DINO2BTX,44,85,-41,-93%
20-04-2016,55757,MAPLEM14BDWBTX,100,22,78,78%
26-08-2015,59515,BELMONTBTX,70,89,-19,-27%
31-12-2015,52371,SALADO 15,15,6,9,60%
05-10-2015,66803,SOMERSETBTX,15,25,-10,-67%
22-04-2016,62904,BEAVERCREEK12BTX,62,96,-34,-55%
01-07-2016,66803,SOMERSETBTX,77,33,44,57%
03-05-2015,61590,DINO2BTX,51,98,-47,-92%
06-01-2015,60150,TULIP15SKLBTX,47,23,24,51%
30-11-2015,59515,BELMONTBTX,50,66,-16,-32%
30-04-2016,52371,SALADO 15,41,50,-9,-22%
12-11-2016,79099,PR52361GO14MLKAE,68,84,-16,-24%
10-04-2016,55757,MAPLEM14BDWBTX,35,69,-34,-97%
12-01-2016,59383,IRIS15BSWBTX,93,10,83,89%
24-02-2015,57515,HOUSTON12CTO,48,63,-15,-31%
20-06-2016,60148,TULIP17BDWBTX,21,88,-67,-319%
29-08-2016,56160,MAGELLAN14CTO1,6,65,-59,-983%
01-07-2017,55757,MAPLEM14BDWBTX,12,24,-12,-100%
12-02-2016,59379,IRIS14BSWBTX,32,49,-17,-53%
15-02-2016,55724,CEDAR14HSWBTX,99,75,24,24%
16-12-2017,62851,PARKCITY12CTO,69,65,4,6%
06-10-2015,199,PARTS,32,42,-10,-31%
11-05-2016,57379,JEFFERSONBTX,67,70,-3,-4%
27-10-2016,81761,PR54102HOUSTN14A,20,6,14,70%
22-06-2016,60147,TULIP15BDWBTX,69,19,50,72%
24-09-2015,57374,FIGTREETAA1,5,23,-18,-360%
18-12-2015,63256,COTTONWOODSKLBTX,59,36,23,39%
07-11-2017,60153,TULIP15AMDBTX,13,66,-53,-408%
24-04-2016,60146,TULIP14BDWBTX,66,20,46,70%
28-02-2016,55724,CEDAR14HSWBTX,84,83,1,1%
11-05-2017,55757,MAPLEM14BDWBTX,17,18,-1,-6%
29-03-2015,73786,PR49493PLANOM,50,64,-14,-28%
23-10-2015,57197,ERIKSSON14CTO1,63,22,41,65%
07-04-2016,60153,TULIP15AMDBTX,91,8,83,91%
28-09-2017,62853,PARKCITY14BTX,64,83,-19,-30%
13-10-2016,57527,HOUSTON15CTO,71,45,26,37%
19-08-2017,55757,MAPLEM14BDWBTX,12,17,-5,-42%
22-10-2016,60704,VANGOGH14BDWBTX,91,32,59,65%
15-05-2016,71653,PR48124PLANOM,8,99,-91,-1138%
14-05-2017,199,PARTS,44,1,43,98%
30-09-2017,75369,PR50337SALADO14,25,67,-42,-168%
28-03-2015,60150,TULIP15SKLBTX,100,49,51,51%
16-08-2015,60150,TULIP15SKLBTX,55,54,1,2%
21-05-2017,74192,DRAXSKLYBTX,15,40,-25,-167%
15-12-2016,56517,REDWOODBTX,65,50,15,23%
18-04-2016,63256,COTTONWOODSKLBTX,100,48,52,52%
20-02-2016,59861,SILVEROAKBTX,57,85,-28,-49%
01-05-2015,61341,MIRAMAR 17,31,88,-57,-184%
13-01-2016,64248,JAYTONBTX,91,30,61,67%
01-01-2015,60813,BERLINETTABTX,77,17,60,78%
26-11-2016,60150,TULIP15SKLBTX,15,35,-20,-133%
18-06-2017,60153,TULIP15AMDBTX,55,17,38,69%
27-07-2016,60147,TULIP15BDWBTX,46,44,2,4%
23-07-2015,78223,PR51831ERIKSNATG,98,75,23,23%
03-01-2016,66803,SOMERSETBTX,60,76,-16,-27%
23-10-2016,199,PARTS,25,85,-60,-240%
07-04-2015,60150,TULIP15SKLBTX,49,63,-14,-29%
13-10-2015,199,PARTS,51,83,-32,-63%
01-09-2016,473,NON_TIED_PERIPHERALS,22,93,-71,-323%
04-08-2016,63886,PANDORA15SKLBTX,80,82,-2,-3%
28-11-2015,57495,GOLIADMLK12CTOE,87,50,37,43%
20-10-2017,60813,BERLINETTABTX,14,65,-51,-364%
10-05-2016,199,PARTS,37,39,-2,-5%
06-09-2016,59383,IRIS15BSWBTX,75,96,-21,-28%
20-03-2017,199,PARTS,75,23,52,69%
20-10-2017,61590,DINO2BTX,84,63,21,25%
07-08-2017,60705,VANGOGH15BDWBTX,95,58,37,39%
18-01-2015,59384,IRIS15BDWBTX,30,5,25,83%
29-01-2015,60813,BERLINETTABTX,55,7,48,87%
08-01-2016,59383,IRIS15BSWBTX,60,79,-19,-32%
31-03-2017,56745,MARBLE FALLS15CTO,99,62,37,37%
07-03-2017,66803,SOMERSETBTX,82,94,-12,-15%
13-06-2016,60150,TULIP15SKLBTX,12,69,-57,-475%
19-01-2017,63886,PANDORA15SKLBTX,62,93,-31,-50%
01-01-2015,60153,TULIP15AMDBTX,94,63,31,33%
09-06-2017,65308,BLACKWELLT4BTX,11,10,1,9%
06-12-2015,62856,PARKCITY15BTX,97,46,51,53%
18-06-2017,60707,VANGOGH15SKLBTX,49,2,47,96%
04-04-2017,66803,SOMERSETBTX,55,14,41,75%
13-08-2017,60147,TULIP15BDWBTX,3,68,-65,-2167%
27-12-2016,60705,VANGOGH15BDWBTX,34,56,-22,-65%
31-08-2017,59384,IRIS15BDWBTX,63,6,57,90%
10-01-2017,65308,BLACKWELLT4BTX,1,23,-22,-2200%
12-05-2015,59384,IRIS15BDWBTX,52,49,3,6%
05-09-2016,199,PARTS,76,4,72,95%
28-05-2016,199,PARTS,24,45,-21,-88%
20-11-2016,61590,DINO2BTX,47,61,-14,-30%
26-09-2017,56745,MARBLE FALLS15CTO,70,72,-2,-3%
01-04-2016,60153,TULIP15AMDBTX,70,34,36,51%
04-05-2017,62853,PARKCITY14BTX,97,31,66,68%
10-04-2017,60705,VANGOGH15BDWBTX,30,79,-49,-163%
02-03-2015,53301,DIESEL15GREYFED,58,13,45,78%
28-01-2015,60150,TULIP15SKLBTX,27,94,-67,-248%
25-04-2015,199,PARTS,64,49,15,23%
05-12-2017,60813,BERLINETTABTX,87,85,2,2%
17-06-2015,60812,VENENOBTX,55,39,16,29%
09-10-2016,60147,TULIP15BDWBTX,7,63,-56,-800%
03-03-2017,199,PARTS,6,31,-25,-417%
16-07-2017,60153,TULIP15AMDBTX,62,6,56,90%
15-03-2015,52370,SALADO 14,98,23,75,77%
23-04-2016,62856,PARKCITY15BTX,24,85,-61,-254%
19-09-2016,65308,BLACKWELLT4BTX,93,64,29,31%
02-04-2017,57514,HOUSTON12CTOE,11,61,-50,-455%
03-10-2016,65308,BLACKWELLT4BTX,46,58,-12,-26%
17-04-2015,62856,PARKCITY15BTX,23,92,-69,-300%
21-04-2017,62853,PARKCITY14BTX,28,62,-34,-121%
15-10-2016,59384,IRIS15BDWBTX,27,69,-42,-156%
12-05-2015,61239,REDWOODMLKBSWBTX,15,35,-20,-133%
24-04-2016,60150,TULIP15SKLBTX,30,71,-41,-137%
07-05-2017,60150,TULIP15SKLBTX,68,67,1,1%
03-04-2017,60150,TULIP15SKLBTX,55,84,-29,-53%
25-07-2015,55724,CEDAR14HSWBTX,41,31,10,24%
03-08-2016,60705,VANGOGH15BDWBTX,1,31,-30,-3000%
20-01-2016,85648,PR56415MIRMAR15O,27,23,4,15%
31-10-2017,59384,IRIS15BDWBTX,4,55,-51,-1275%
27-01-2015,55724,CEDAR14HSWBTX,42,73,-31,-74%
05-10-2017,60812,VENENOBTX,90,93,-3,-3%
02-01-2015,57368,FIGTREECTO,32,37,-5,-16%
28-11-2016,60705,VANGOGH15BDWBTX,76,40,36,47%
13-02-2017,57499,GOLIADMLK14BTXE,39,9,30,77%
23-11-2015,60705,VANGOGH15BDWBTX,31,74,-43,-139%
10-06-2015,64248,JAYTONBTX,34,89,-55,-162%
13-09-2016,60812,VENENOBTX,93,46,47,51%
14-07-2015,57454,JANUS15BDWBTX,32,88,-56,-175%
09-09-2015,61590,DINO2BTX,56,25,31,55%
20-04-2015,76276,PR50904MAGELLXFR,37,98,-61,-165%
09-01-2016,60704,VANGOGH14BDWBTX,55,46,9,16%
09-07-2017,64248,JAYTONBTX,48,91,-43,-90%
20-05-2017,62908,BEAVERCREEK14CTO,96,67,29,30%
13-06-2016,199,PARTS,94,14,80,85%
05-03-2016,53850,DIESEL15CTO,1,94,-93,-9300%
19-12-2015,60153,TULIP15AMDBTX,53,54,-1,-2%
21-08-2016,62856,PARKCITY15BTX,11,21,-10,-91%
03-09-2017,199,PARTS,14,47,-33,-236%
01-01-2016,68337,ROUND ROCKMLKBTX,28,70,-42,-150%
08-10-2016,60704,VANGOGH14BDWBTX,90,10,80,89%
23-11-2015,62908,BEAVERCREEK14CTO,17,89,-72,-424%
13-08-2017,68337,ROUND ROCKMLKBTX,51,65,-14,-27%
06-02-2015,57623,CRESTEDBUTTECTO1,15,97,-82,-547%
29-07-2016,56746,MARBLE FALLS15BTX,94,63,31,33%
21-03-2016,59384,IRIS15BDWBTX,31,97,-66,-213%
07-07-2015,199,PARTS,63,89,-26,-41%
24-09-2015,60704,VANGOGH14BDWBTX,31,21,10,32%
19-01-2015,53539,ALPINE 14,34,59,-25,-74%
26-05-2017,59861,SILVEROAKBTX,14,47,-33,-236%
16-11-2015,60150,TULIP15SKLBTX,85,22,63,74%
01-12-2017,60705,VANGOGH15BDWBTX,28,45,-17,-61%
22-03-2016,62882,LOVELAND14SCTO,18,71,-53,-294%
13-03-2015,60813,BERLINETTABTX,51,66,-15,-29%
15-10-2015,62856,PARKCITY15BTX,47,57,-10,-21%
03-06-2015,60704,VANGOGH14BDWBTX,42,84,-42,-100%
25-01-2017,60153,TULIP15AMDBTX,97,25,72,74%
27-11-2016,60705,VANGOGH15BDWBTX,60,12,48,80%
18-12-2015,60705,VANGOGH15BDWBTX,19,91,-72,-379%
22-11-2016,52370,SALADO 14,4,42,-38,-950%
19-05-2016,57454,JANUS15BDWBTX,7,77,-70,-1000%
09-06-2016,199,PARTS,7,38,-31,-443%
04-10-2015,199,PARTS,25,2,23,92%
03-09-2017,473,NON_TIED_PERIPHERALS,9,59,-50,-556%
28-10-2015,60147,TULIP15BDWBTX,50,76,-26,-52%
10-02-2015,63254,REDWOODBSKLBTX,4,8,-4,-100%
14-03-2016,57515,HOUSTON12CTO,4,8,-4,-100%
22-03-2016,61239,REDWOODMLKBSWBTX,77,43,34,44%
02-05-2015,60150,TULIP15SKLBTX,48,69,-21,-44%
10-02-2016,60813,BERLINETTABTX,27,37,-10,-37%
22-03-2016,59861,SILVEROAKBTX,31,10,21,68%
12-11-2016,61336,BERLINETTAPCTO,69,47,22,32%
18-10-2016,199,PARTS,75,70,5,7%
02-07-2015,60812,VENENOBTX,34,3,31,91%
19-08-2015,57454,JANUS15BDWBTX,4,58,-54,-1350%
18-10-2016,60150,TULIP15SKLBTX,66,87,-21,-32%
05-10-2017,61590,DINO2BTX,16,73,-57,-356%
02-05-2017,57527,HOUSTON15CTO,99,98,1,1%
30-01-2015,67525,PRGOLIADMLK122,63,22,41,65%
28-11-2017,60150,TULIP15SKLBTX,5,78,-73,-1460%
20-07-2016,60150,TULIP15SKLBTX,14,22,-8,-57%
26-04-2015,60148,TULIP17BDWBTX,38,56,-18,-47%
16-08-2017,61949,LIVINGSTONECTO,43,90,-47,-109%
03-09-2015,61333,BERLINETTA P,55,25,30,55%
19-08-2015,82280,PR54499PLANOB,55,57,-2,-4%
13-06-2015,60705,VANGOGH15BDWBTX,37,87,-50,-135%
15-12-2015,56746,MARBLE FALLS15BTX,45,19,26,58%
03-09-2016,199,PARTS,54,80,-26,-48%
19-05-2015,59383,IRIS15BSWBTX,80,14,66,83%
22-04-2016,61239,REDWOODMLKBSWBTX,1,11,-10,-1000%
02-03-2016,60705,VANGOGH15BDWBTX,36,59,-23,-64%
21-08-2017,62856,PARKCITY15BTX,41,96,-55,-134%
21-12-2015,60150,TULIP15SKLBTX,49,24,25,51%
05-09-2016,60150,TULIP15SKLBTX,65,34,31,48%
11-10-2015,60153,TULIP15AMDBTX,34,59,-25,-74%
11-04-2015,60148,TULIP17BDWBTX,28,51,-23,-82%
25-03-2017,73519,PR49168HOUSTN14O,87,77,10,11%
23-05-2017,60150,TULIP15SKLBTX,77,92,-15,-19%
22-08-2015,62853,PARKCITY14BTX,65,32,33,51%
29-10-2016,60150,TULIP15SKLBTX,87,68,19,22%
21-03-2015,60150,TULIP15SKLBTX,97,74,23,24%
01-05-2015,57454,JANUS15BDWBTX,26,22,4,15%
16-06-2016,60150,TULIP15SKLBTX,77,48,29,38%
23-06-2017,62853,PARKCITY14BTX,51,95,-44,-86%
24-07-2017,68337,ROUND ROCKMLKBTX,63,96,-33,-52%
25-03-2017,68337,ROUND ROCKMLKBTX,11,15,-4,-36%
09-10-2017,56746,MARBLE FALLS15BTX,1,19,-18,-1800%
28-11-2015,60147,TULIP15BDWBTX,100,10,90,90%
30-08-2015,199,PARTS,97,4,93,96%
26-03-2015,60704,VANGOGH14BDWBTX,96,23,73,76%
24-01-2015,199,PARTS,16,53,-37,-231%
23-03-2015,63256,COTTONWOODSKLBTX,15,94,-79,-527%
06-10-2016,81753,PR54116GO12MLKAE,55,69,-14,-25%
08-12-2016,57616,CRESTED BUTTEBTX,63,75,-12,-19%
07-12-2017,62853,PARKCITY14BTX,88,25,63,72%
14-11-2015,62908,BEAVERCREEK14CTO,74,89,-15,-20%
01-11-2016,57616,CRESTED BUTTEBTX,12,82,-70,-583%
26-03-2016,56746,MARBLE FALLS15BTX,14,59,-45,-321%
03-09-2017,60150,TULIP15SKLBTX,43,36,7,16%
01-01-2017,60705,VANGOGH15BDWBTX,56,36,20,36%
06-03-2016,68338,ROUND ROCKMLKCTO,93,24,69,74%
26-02-2017,60705,VANGOGH15BDWBTX,86,65,21,24%
24-01-2015,62904,BEAVERCREEK12BTX,45,68,-23,-51%
06-05-2016,56746,MARBLE FALLS15BTX,30,25,5,17%
27-11-2016,57496,GOLIADMLK12TAAE,86,60,26,30%
07-08-2017,62907,BEAVERCREEK14BTX,32,50,-18,-56%
01-09-2015,62912,BEAVERCREEK12FTAA,53,59,-6,-11%
17-06-2017,64248,JAYTONBTX,9,10,-1,-11%
23-10-2015,62851,PARKCITY12CTO,10,30,-20,-200%
30-09-2016,63886,PANDORA15SKLBTX,37,67,-30,-81%
29-03-2016,59385,IRIS15SKLBTX,86,75,11,13%
07-01-2016,60147,TULIP15BDWBTX,45,46,-1,-2%
23-09-2016,199,PARTS,98,50,48,49%
08-06-2016,55751,MAPLEM14HSWBTX,100,60,40,40%
30-07-2016,473,NON_TIED_PERIPHERALS,16,65,-49,-306%
02-04-2016,60150,TULIP15SKLBTX,45,28,17,38%
28-07-2017,57379,JEFFERSONBTX,54,89,-35,-65%
10-01-2015,62879,LOVELAND15BBTX,65,42,23,35%
22-08-2015,199,PARTS,48,71,-23,-48%
15-03-2016,62853,PARKCITY14BTX,8,50,-42,-525%
10-03-2016,56746,MARBLE FALLS15BTX,76,4,72,95%
23-05-2017,60146,TULIP14BDWBTX,84,33,51,61%
01-03-2015,53542,ALPINE 15,44,81,-37,-84%
28-09-2016,83523,PR55113GO14MLKOE,59,68,-9,-15%
09-07-2017,53542,ALPINE 15,27,54,-27,-100%
11-02-2015,60151,TULIP17SKLBTX,29,72,-43,-148%
23-09-2016,57379,JEFFERSONBTX,4,79,-75,-1875%
26-05-2016,57513,HOUSTON12BTX,63,14,49,78%
10-09-2015,60153,TULIP15AMDBTX,54,17,37,69%
02-12-2017,62875,PARKCITY15CTO1,22,86,-64,-291%
16-07-2017,61339,MIRAMAR 15,81,68,13,16%
03-08-2016,57495,GOLIADMLK12CTOE,51,38,13,25%
21-05-2016,53539,ALPINE 14,28,53,-25,-89%
21-01-2016,199,PARTS,45,92,-47,-104%
30-05-2017,57521,HOUSTON14CTO,67,24,43,64%
22-10-2017,199,PARTS,99,69,30,30%
05-03-2016,62853,PARKCITY14BTX,5,90,-85,-1700%
09-09-2015,62880,LOVELAND15SCTO,29,41,-12,-41%
26-11-2015,60704,VANGOGH14BDWBTX,61,70,-9,-15%
25-05-2015,57379,JEFFERSONBTX,22,28,-6,-27%
23-10-2017,57525,HOUSTON15BTX,38,1,37,97%
12-02-2016,59381,IRIS14SKLBTX,76,61,15,20%
10-09-2016,60705,VANGOGH15BDWBTX,42,99,-57,-136%
29-01-2017,60150,TULIP15SKLBTX,77,92,-15,-19%
13-07-2015,60153,TULIP15AMDBTX,56,42,14,25%
28-03-2017,62907,BEAVERCREEK14BTX,26,17,9,35%
20-06-2017,60153,TULIP15AMDBTX,94,100,-6,-6%
24-06-2017,84010,PR48088BVRCRK12,34,73,-39,-115%
03-02-2017,60147,TULIP15BDWBTX,97,98,-1,-1%
17-09-2016,199,PARTS,93,12,81,87%
24-11-2016,61339,MIRAMAR 15,93,73,20,22%
29-04-2017,72819,PR48877GOL12MLKA,37,27,10,27%
16-08-2017,60153,TULIP15AMDBTX,80,56,24,30%
29-11-2015,60153,TULIP15AMDBTX,25,22,3,12%
14-02-2015,61333,BERLINETTA P,83,1,82,99%
11-08-2015,60704,VANGOGH14BDWBTX,35,12,23,66%
08-12-2016,60150,TULIP15SKLBTX,80,52,28,35%
13-11-2017,199,PARTS,21,25,-4,-19%
01-05-2017,60150,TULIP15SKLBTX,72,28,44,61%
04-05-2015,60704,VANGOGH14BDWBTX,95,1,94,99%
26-10-2017,57379,JEFFERSONBTX,42,55,-13,-31%
20-09-2017,62907,BEAVERCREEK14BTX,93,67,26,28%
22-10-2016,59384,IRIS15BDWBTX,93,94,-1,-1%
18-03-2015,57525,HOUSTON15BTX,79,50,29,37%
29-04-2017,57379,JEFFERSONBTX,54,6,48,89%
07-10-2017,60150,TULIP15SKLBTX,100,57,43,43%
06-06-2017,60704,VANGOGH14BDWBTX,18,87,-69,-383%
13-05-2017,199,PARTS,97,55,42,43%
07-08-2017,83537,PR55197PRKCTY15O,7,90,-83,-1186%
08-01-2016,60705,VANGOGH15BDWBTX,25,24,1,4%
26-06-2015,57525,HOUSTON15BTX,25,40,-15,-60%
05-09-2015,60150,TULIP15SKLBTX,90,5,85,94%
30-11-2015,199,PARTS,78,22,56,72%
05-10-2017,62879,LOVELAND15BBTX,52,99,-47,-90%
09-02-2015,57379,JEFFERSONBTX,38,16,22,58%
10-05-2016,74469,PR49844COLUMXFR,5,21,-16,-320%
04-08-2016,63256,COTTONWOODSKLBTX,58,72,-14,-24%
24-12-2015,79982,PR53038PLANOM,78,49,29,37%
06-06-2015,62850,PARKCITY12BTX,32,59,-27,-84%
04-02-2015,56160,MAGELLAN14CTO1,32,76,-44,-138%
05-04-2017,62883,LOVELAND15BCTO,8,55,-47,-588%
01-11-2017,69925,CELTICCTO,38,94,-56,-147%
15-06-2015,52375,SALADO 14 CTO,87,31,56,64%
16-03-2017,61590,DINO2BTX,27,84,-57,-211%
07-09-2017,57525,HOUSTON15BTX,43,3,40,93%
01-11-2015,57379,JEFFERSONBTX,44,16,28,64%
29-04-2017,54142,TESTAROSSA P,40,80,-40,-100%
14-12-2015,57520,HOUSTON14CTOE,21,46,-25,-119%
20-10-2015,199,PARTS,43,20,23,53%
04-09-2015,63251,BLACKWOODSKLBTX,78,67,11,14%
06-01-2015,56746,MARBLE FALLS15BTX,32,53,-21,-66%
25-01-2017,61236,BLACKWOODBDWBTX,100,36,64,64%
09-04-2015,60825,BOLDPEAK2,96,7,89,93%
03-08-2016,199,PARTS,86,11,75,87%
12-11-2015,60148,TULIP17BDWBTX,21,79,-58,-276%
05-08-2016,62879,LOVELAND15BBTX,83,88,-5,-6%
16-12-2015,61949,LIVINGSTONECTO,15,57,-42,-280%
27-03-2017,63256,COTTONWOODSKLBTX,28,99,-71,-254%
17-04-2016,61333,BERLINETTA P,54,17,37,69%
02-11-2015,57525,HOUSTON15BTX,84,36,48,57%
31-07-2015,80377,PR53281RNDRCKMLK,72,88,-16,-22%
05-02-2015,199,PARTS,13,52,-39,-300%
31-03-2016,62888,LOVELAND14FSCTO,39,11,28,72%
29-01-2017,76973,PR51318SALADO15,43,100,-57,-133%
07-10-2015,63251,BLACKWOODSKLBTX,17,83,-66,-388%
05-09-2016,60150,TULIP15SKLBTX,74,47,27,36%
02-03-2017,199,PARTS,13,26,-13,-100%
17-10-2015,199,PARTS,18,57,-39,-217%
21-08-2017,62905,BEAVERCREEK12CTO,86,10,76,88%
30-12-2016,62872,PARKCITY14CTO1,33,85,-52,-158%
06-09-2015,63095,MERIDIANBTX,77,52,25,32%
28-06-2015,60150,TULIP15SKLBTX,42,83,-41,-98%
19-11-2017,60705,VANGOGH15BDWBTX,13,62,-49,-377%
08-11-2016,199,PARTS,56,88,-32,-57%
15-01-2017,60153,TULIP15AMDBTX,71,86,-15,-21%
11-08-2017,62881,LOVELAND14SBTX,47,96,-49,-104%
04-02-2017,199,PARTS,45,44,1,2%
25-11-2017,53302,DIESEL17GREYFED,64,20,44,69%
14-05-2015,60147,TULIP15BDWBTX,65,20,45,69%
01-10-2017,61236,BLACKWOODBDWBTX,70,61,9,13%
22-05-2016,52375,SALADO 14 CTO,7,16,-9,-129%
07-02-2015,62881,LOVELAND14SBTX,92,93,-1,-1%
22-08-2015,62857,PARKCITY15CTO,42,93,-51,-121%
17-01-2017,62856,PARKCITY15BTX,13,58,-45,-346%
22-02-2015,73929,DRAXBTX,100,83,17,17%
25-11-2015,62882,LOVELAND14SCTO,2,66,-64,-3200%
03-06-2017,60147,TULIP15BDWBTX,9,79,-70,-778%
15-12-2015,60150,TULIP15SKLBTX,100,1,99,99%
25-06-2015,57497,GOLIADMLK14CTOE,93,83,10,11%
25-01-2016,199,PARTS,5,74,-69,-1380%
15-05-2015,62856,PARKCITY15BTX,32,18,14,44%
12-11-2017,199,PARTS,86,70,16,19%
26-02-2017,60147,TULIP15BDWBTX,55,64,-9,-16%
03-11-2017,62856,PARKCITY15BTX,29,53,-24,-83%
24-11-2017,53291,DIESEL 15,40,17,23,58%
26-09-2016,54983,ROUND ROCK,58,76,-18,-31%
23-04-2015,57519,HOUSTON14BTX,50,5,45,90%
29-04-2016,199,PARTS,34,35,-1,-3%
16-06-2017,57527,HOUSTON15CTO,33,58,-25,-76%
11-07-2016,199,PARTS,54,39,15,28%
06-10-2017,199,PARTS,41,5,36,88%
07-12-2015,65308,BLACKWELLT4BTX,28,50,-22,-79%
02-10-2016,63251,BLACKWOODSKLBTX,29,12,17,59%
25-10-2017,199,PARTS,7,71,-64,-914%
19-02-2015,84419,PR55850SOMERSET,33,85,-52,-158%
05-05-2015,60148,TULIP17BDWBTX,9,76,-67,-744%
03-09-2016,63095,MERIDIANBTX,73,47,26,36%
10-08-2016,60147,TULIP15BDWBTX,41,2,39,95%
23-09-2016,60813,BERLINETTABTX,53,98,-45,-85%
07-01-2017,56746,MARBLE FALLS15BTX,15,56,-41,-273%
21-02-2017,60153,TULIP15AMDBTX,51,77,-26,-51%
02-06-2017,199,PARTS,90,84,6,7%
31-03-2015,68337,ROUND ROCKMLKBTX,28,17,11,39%
12-08-2017,57497,GOLIADMLK14CTOE,37,8,29,78%
09-03-2015,199,PARTS,39,76,-37,-95%
19-12-2016,199,PARTS,51,19,32,63%
23-04-2017,54983,ROUND ROCK,100,60,40,40%
18-09-2017,60147,TULIP15BDWBTX,54,9,45,83%
21-05-2017,69923,CELTICBTX,63,79,-16,-25%
17-07-2015,63256,COTTONWOODSKLBTX,74,27,47,64%
02-03-2015,62879,LOVELAND15BBTX,47,72,-25,-53%
18-09-2016,57617,CRESTED BUTTECTO,68,10,58,85%
15-02-2017,62857,PARKCITY15CTO,45,31,14,31%
01-01-2017,57616,CRESTED BUTTEBTX,29,79,-50,-172%
09-12-2015,199,PARTS,28,34,-6,-21%
22-02-2017,62856,PARKCITY15BTX,29,27,2,7%
12-03-2016,69925,CELTICCTO,100,51,49,49%
20-04-2015,63256,COTTONWOODSKLBTX,15,100,-85,-567%
16-09-2017,63256,COTTONWOODSKLBTX,46,12,34,74%
24-09-2016,63095,MERIDIANBTX,80,60,20,25%
28-01-2016,199,PARTS,71,100,-29,-41%
18-11-2016,199,PARTS,77,9,68,88%
20-09-2017,62904,BEAVERCREEK12BTX,87,45,42,48%
26-01-2017,67623,MONET14SKLBTX,90,85,5,6%
15-06-2017,199,PARTS,95,57,38,40%
19-11-2017,60813,BERLINETTABTX,89,86,3,3%
01-11-2015,55727,CEDAR14BDWBTX,16,84,-68,-425%
24-04-2016,63256,COTTONWOODSKLBTX,1,95,-94,-9400%
08-02-2016,63399,ECHO 17 MLK CTO,44,89,-45,-102%
25-03-2017,71894,PR48136LIVNGSTON,99,92,7,7%
05-04-2017,62850,PARKCITY12BTX,82,2,80,98%
14-01-2015,60150,TULIP15SKLBTX,73,26,47,64%
07-03-2017,60147,TULIP15BDWBTX,90,99,-9,-10%
01-11-2016,62856,PARKCITY15BTX,95,60,35,37%
24-07-2016,62882,LOVELAND14SCTO,8,83,-75,-938%
25-06-2017,63256,COTTONWOODSKLBTX,92,98,-6,-7%
15-12-2016,57515,HOUSTON12CTO,48,64,-16,-33%
20-08-2017,57519,HOUSTON14BTX,78,41,37,47%
29-07-2016,55725,CEDAR15HSWBTX,84,62,22,26%
04-07-2016,52370,SALADO 14,47,11,36,77%
07-04-2016,62875,PARKCITY15CTO1,17,96,-79,-465%
25-06-2015,69923,CELTICBTX,6,42,-36,-600%
15-10-2017,55725,CEDAR15HSWBTX,1,33,-32,-3200%
23-12-2016,62854,PARKCITY14CTO,79,12,67,85%
04-10-2017,199,PARTS,61,94,-33,-54%
17-08-2017,63255,COTTONWOODBSKLBTX,62,54,8,13%
07-08-2017,53512,GOLIAD 14,45,59,-14,-31%
05-06-2015,62853,PARKCITY14BTX,20,8,12,60%
13-02-2015,199,PARTS,35,61,-26,-74%
09-02-2017,52370,SALADO 14,32,92,-60,-188%
20-08-2016,61341,MIRAMAR 17,14,4,10,71%
02-12-2016,199,PARTS,86,16,70,81%
08-02-2016,71199,PR47772SALADO15,32,63,-31,-97%
07-05-2016,38851,SQUEEZE,45,50,-5,-11%
09-04-2015,63095,MERIDIANBTX,36,24,12,33%
11-06-2016,199,PARTS,5,53,-48,-960%
14-10-2016,67527,PRGOLIADMLK142,17,67,-50,-294%
05-01-2015,56744,MARBLE FALLS14BTX,49,46,3,6%
26-11-2016,52370,SALADO 14,6,56,-50,-833%
21-12-2016,199,PARTS,79,44,35,44%
08-06-2015,63256,COTTONWOODSKLBTX,16,84,-68,-425%
04-01-2016,60154,TULIP17AMDBTX,41,87,-46,-112%
05-10-2017,59670,PLANOBCTO,83,93,-10,-12%
21-04-2017,60153,TULIP15AMDBTX,33,94,-61,-185%
25-04-2015,199,PARTS,6,99,-93,-1550%
14-01-2017,60813,BERLINETTABTX,6,55,-49,-817%
16-11-2015,57525,HOUSTON15BTX,24,73,-49,-204%
17-02-2017,57379,JEFFERSONBTX,31,41,-10,-32%
07-06-2017,57526,HOUSTON15CTOE,75,9,66,88%
11-07-2017,74490,PR49850HOUSTN15O,96,73,23,24%
13-10-2015,57495,GOLIADMLK12CTOE,88,14,74,84%
19-05-2017,60813,BERLINETTABTX,66,50,16,24%
01-07-2017,60149,TULIP14SKLBTX,23,71,-48,-209%
07-04-2017,60151,TULIP17SKLBTX,94,17,77,82%
03-11-2017,199,PARTS,46,2,44,96%
03-01-2017,199,PARTS,16,42,-26,-163%
05-05-2016,60150,TULIP15SKLBTX,77,59,18,23%
25-10-2016,57283,COTTONWOODBDWBTX,71,73,-2,-3%
10-12-2015,57379,JEFFERSONBTX,40,97,-57,-143%
12-10-2016,60813,BERLINETTABTX,84,4,80,95%
25-03-2016,57525,HOUSTON15BTX,66,83,-17,-26%
19-01-2015,80004,PR40466BERLINEA,3,23,-20,-667%
03-03-2015,60151,TULIP17SKLBTX,40,97,-57,-143%
20-10-2017,60707,VANGOGH15SKLBTX,33,13,20,61%
26-04-2016,62880,LOVELAND15SCTO,74,29,45,61%
29-09-2016,63251,BLACKWOODSKLBTX,44,4,40,91%
27-01-2017,66803,SOMERSETBTX,63,4,59,94%
08-03-2016,60153,TULIP15AMDBTX,53,40,13,25%
01-05-2016,57521,HOUSTON14CTO,39,75,-36,-92%
23-03-2017,60813,BERLINETTABTX,25,9,16,64%
10-07-2017,67623,MONET14SKLBTX,16,7,9,56%
16-01-2015,85727,PR56598PRKCTY14O,75,76,-1,-1%
15-01-2016,57379,JEFFERSONBTX,52,29,23,44%
17-04-2016,57521,HOUSTON14CTO,91,2,89,98%
20-04-2015,63251,BLACKWOODSKLBTX,41,32,9,22%
29-01-2016,75895,PR50803GOL14MLKO,5,84,-79,-1580%
21-05-2017,60147,TULIP15BDWBTX,98,24,74,76%
22-08-2016,59515,BELMONTBTX,94,24,70,74%
05-04-2015,62853,PARKCITY14BTX,94,18,76,81%
13-03-2016,63256,COTTONWOODSKLBTX,56,59,-3,-5%
08-04-2017,60813,BERLINETTABTX,19,45,-26,-137%
25-08-2017,57527,HOUSTON15CTO,98,60,38,39%
19-05-2017,54984,ROUND ROCKBTX,90,24,66,73%
17-12-2015,54984,ROUND ROCKBTX,61,71,-10,-16%
29-05-2016,57453,JANUS15HSWBTX,79,96,-17,-22%
26-08-2015,59670,PLANOBCTO,81,2,79,98%
02-04-2016,57513,HOUSTON12BTX,9,17,-8,-89%
12-08-2015,57379,JEFFERSONBTX,63,100,-37,-59%
17-11-2015,61949,LIVINGSTONECTO,6,23,-17,-283%
15-06-2017,55758,MAPLEM15BDWBTX,19,48,-29,-153%
08-11-2016,199,PARTS,4,30,-26,-650%
04-09-2016,62850,PARKCITY12BTX,53,78,-25,-47%
01-06-2017,62856,PARKCITY15BTX,21,81,-60,-286%
21-01-2017,55758,MAPLEM15BDWBTX,37,51,-14,-38%
24-08-2016,56151,MAGELLAN14CTO,49,85,-36,-73%
17-10-2016,55758,MAPLEM15BDWBTX,100,55,45,45%
13-08-2015,73463,PR49182SILVERTON,94,17,77,82%
23-04-2017,62905,BEAVERCREEK12CTO,15,34,-19,-127%
05-05-2017,63256,COTTONWOODSKLBTX,85,14,71,84%
25-03-2015,62908,BEAVERCREEK14CTO,10,47,-37,-370%
05-09-2016,63256,COTTONWOODSKLBTX,34,56,-22,-65%
29-08-2016,60148,TULIP17BDWBTX,77,53,24,31%
12-01-2016,56151,MAGELLAN14CTO,92,88,4,4%
16-12-2016,63256,COTTONWOODSKLBTX,74,48,26,35%
05-02-2016,63256,COTTONWOODSKLBTX,62,96,-34,-55%
26-01-2017,68337,ROUND ROCKMLKBTX,29,34,-5,-17%
03-11-2016,63255,COTTONWOODBSKLBTX,61,21,40,66%
14-01-2016,62878,LOVELAND14BCTO,77,60,17,22%
22-01-2016,63251,BLACKWOODSKLBTX,49,87,-38,-78%
23-02-2015,62853,PARKCITY14BTX,74,63,11,15%
13-03-2016,62857,PARKCITY15CTO,53,36,17,32%
07-02-2015,62879,LOVELAND15BBTX,1,72,-71,-7100%
24-11-2016,66803,SOMERSETBTX,30,83,-53,-177%
11-05-2016,68343,ROUNDROCKMLKCTO1,15,68,-53,-353%
30-11-2017,56517,REDWOODBTX,15,14,1,7%
19-06-2015,55758,MAPLEM15BDWBTX,24,77,-53,-221%
09-07-2016,53291,DIESEL 15,60,51,9,15%
04-03-2016,68338,ROUND ROCKMLKCTO,79,53,26,33%
29-09-2015,59384,IRIS15BDWBTX,29,20,9,31%
13-06-2016,61336,BERLINETTAPCTO,14,22,-8,-57%
23-07-2016,57527,HOUSTON15CTO,16,88,-72,-450%
14-09-2016,64250,JAYTONSECUREBTX,54,38,16,30%
10-08-2017,199,PARTS,97,31,66,68%
24-03-2015,63256,COTTONWOODSKLBTX,52,87,-35,-67%
22-12-2016,60825,BOLDPEAK2,26,35,-9,-35%
01-12-2015,54984,ROUND ROCKBTX,74,14,60,81%
23-06-2017,62853,PARKCITY14BTX,18,70,-52,-289%
28-07-2016,63399,ECHO 17 MLK CTO,75,88,-13,-17%
18-07-2017,54984,ROUND ROCKBTX,65,96,-31,-48%
05-11-2015,59384,IRIS15BDWBTX,84,95,-11,-13%
15-08-2016,67623,MONET14SKLBTX,39,11,28,72%
03-10-2016,60822,BOLDPEAK2BTX,75,40,35,47%
08-03-2016,60825,BOLDPEAK2,9,44,-35,-389%
10-04-2016,60150,TULIP15SKLBTX,96,39,57,59%
17-06-2015,199,PARTS,60,82,-22,-37%
18-02-2015,63256,COTTONWOODSKLBTX,73,98,-25,-34%
23-09-2017,60813,BERLINETTABTX,26,16,10,38%
15-06-2017,68337,ROUND ROCKMLKBTX,12,46,-34,-283%
02-08-2017,56746,MARBLE FALLS15BTX,76,100,-24,-32%
25-05-2015,60813,BERLINETTABTX,96,64,32,33%
11-08-2017,60813,BERLINETTABTX,80,87,-7,-9%
02-12-2015,57283,COTTONWOODBDWBTX,27,23,4,15%
19-07-2015,64248,JAYTONBTX,15,11,4,27%
18-08-2015,62905,BEAVERCREEK12CTO,53,40,13,25%
18-03-2017,62856,PARKCITY15BTX,40,7,33,83%
15-12-2017,69925,CELTICCTO,37,18,19,51%
21-10-2015,59861,SILVEROAKBTX,99,94,5,5%
22-04-2016,57529,HOUSTON15TAA,100,8,92,92%
20-10-2015,59861,SILVEROAKBTX,90,65,25,28%
18-09-2016,81758,PR53944HOUSTN14O,54,68,-14,-26%
04-06-2015,62880,LOVELAND15SCTO,27,65,-38,-141%
26-10-2015,80822,PR46704GOLI14MLK,80,81,-1,-1%
29-06-2016,199,PARTS,23,22,1,4%
18-06-2015,59860,SILVERTONBTX,35,66,-31,-89%
27-10-2015,84746,PR48486BERLINEA,16,54,-38,-238%
31-07-2017,62881,LOVELAND14SBTX,80,87,-7,-9%
18-09-2017,52371,SALADO 15,73,76,-3,-4%
18-09-2015,64248,JAYTONBTX,26,65,-39,-150%
24-02-2015,63886,PANDORA15SKLBTX,32,67,-35,-109%
06-06-2016,53850,DIESEL15CTO,38,85,-47,-124%
12-08-2015,60705,VANGOGH15BDWBTX,99,77,22,22%
16-07-2015,60813,BERLINETTABTX,44,71,-27,-61%
26-05-2016,57497,GOLIADMLK14CTOE,67,25,42,63%
10-12-2016,57495,GOLIADMLK12CTOE,84,66,18,21%
20-06-2016,55725,CEDAR15HSWBTX,27,34,-7,-26%
11-03-2015,55725,CEDAR15HSWBTX,2,9,-7,-350%
03-11-2015,62907,BEAVERCREEK14BTX,6,40,-34,-567%
19-03-2015,56746,MARBLE FALLS15BTX,95,66,29,31%
06-06-2017,51433,VIKING CTO,73,16,57,78%
05-04-2015,60707,VANGOGH15SKLBTX,86,30,56,65%
01-07-2015,62856,PARKCITY15BTX,57,61,-4,-7%
23-07-2017,55725,CEDAR15HSWBTX,65,58,7,11%
17-04-2015,59515,BELMONTBTX,76,86,-10,-13%
23-01-2016,62881,LOVELAND14SBTX,24,100,-76,-317%
19-02-2017,199,PARTS,30,37,-7,-23%
08-03-2017,63886,PANDORA15SKLBTX,37,27,10,27%
28-01-2016,199,PARTS,7,30,-23,-329%
04-11-2016,60813,BERLINETTABTX,12,48,-36,-300%
18-10-2016,62881,LOVELAND14SBTX,24,83,-59,-246%
10-09-2016,199,PARTS,24,67,-43,-179%
25-09-2017,57495,GOLIADMLK12CTOE,81,62,19,23%
22-05-2015,57637,FOXGLOVEBTX,86,52,34,40%
16-12-2016,62883,LOVELAND15BCTO,33,87,-54,-164%
09-05-2015,57520,HOUSTON14CTOE,56,50,6,11%
09-12-2017,55725,CEDAR15HSWBTX,77,82,-5,-6%
11-09-2015,59860,SILVERTONBTX,15,39,-24,-160%
19-05-2017,65308,BLACKWELLT4BTX,14,92,-78,-557%
10-11-2017,62853,PARKCITY14BTX,10,4,6,60%
28-10-2016,62907,BEAVERCREEK14BTX,76,34,42,55%
29-11-2015,68337,ROUND ROCKMLKBTX,30,83,-53,-177%
30-04-2017,58165,ECHO 15 CTO,65,35,30,46%
16-02-2015,199,PARTS,39,45,-6,-15%
09-08-2016,59379,IRIS14BSWBTX,61,85,-24,-39%
26-09-2015,52370,SALADO 14,37,70,-33,-89%
02-03-2017,57453,JANUS15HSWBTX,30,3,27,90%
28-08-2015,62856,PARKCITY15BTX,3,34,-31,-1033%
06-11-2015,61333,BERLINETTA P,86,65,21,24%
24-04-2015,32575,BRUTUS,70,50,20,29%
25-08-2016,62881,LOVELAND14SBTX,2,30,-28,-1400%
26-03-2017,60147,TULIP15BDWBTX,80,98,-18,-23%
25-10-2015,59384,IRIS15BDWBTX,58,99,-41,-71%
01-10-2015,57191,ERIKSSON14CTO,58,75,-17,-29%
06-03-2015,62881,LOVELAND14SBTX,43,13,30,70%
24-01-2015,59384,IRIS15BDWBTX,43,70,-27,-63%
17-09-2016,199,PARTS,49,89,-40,-82%
26-08-2016,62856,PARKCITY15BTX,9,61,-52,-578%
14-05-2015,56746,MARBLE FALLS15BTX,81,77,4,5%
08-01-2016,60707,VANGOGH15SKLBTX,37,70,-33,-89%
11-03-2016,57495,GOLIADMLK12CTOE,15,4,11,73%
04-05-2016,62881,LOVELAND14SBTX,21,89,-68,-324%
12-04-2016,55725,CEDAR15HSWBTX,60,97,-37,-62%
11-01-2015,199,PARTS,9,38,-29,-322%
14-02-2017,62888,LOVELAND14FSCTO,36,24,12,33%
30-01-2017,57497,GOLIADMLK14CTOE,74,41,33,45%
06-01-2016,60150,TULIP15SKLBTX,48,66,-18,-38%
29-03-2017,60147,TULIP15BDWBTX,23,46,-23,-100%
22-05-2015,62881,LOVELAND14SBTX,2,95,-93,-4650%
27-10-2017,68343,ROUNDROCKMLKCTO1,66,15,51,77%
17-04-2015,56151,MAGELLAN14CTO,69,27,42,61%
28-02-2017,199,PARTS,23,53,-30,-130%
01-03-2016,57495,GOLIADMLK12CTOE,38,20,18,47%
20-12-2017,199,PARTS,10,39,-29,-290%
28-01-2015,62856,PARKCITY15BTX,54,59,-5,-9%
31-07-2017,199,PARTS,33,39,-6,-18%
15-12-2015,62881,LOVELAND14SBTX,45,67,-22,-49%
26-05-2016,60707,VANGOGH15SKLBTX,75,91,-16,-21%
03-10-2016,60707,VANGOGH15SKLBTX,54,34,20,37%
29-05-2015,57379,JEFFERSONBTX,24,90,-66,-275%
20-05-2017,63039,PARKCITY-P15CTO,13,20,-7,-54%
26-01-2015,62881,LOVELAND14SBTX,83,8,75,90%
11-12-2015,54983,ROUND ROCK,91,88,3,3%
09-07-2017,57514,HOUSTON12CTOE,46,7,39,85%
14-05-2017,53775,LATITUDE OAK14,52,46,6,12%
15-10-2016,57520,HOUSTON14CTOE,3,92,-89,-2967%
10-10-2017,62880,LOVELAND15SCTO,6,1,5,83%
26-09-2016,64250,JAYTONSECUREBTX,4,41,-37,-925%
24-07-2017,62880,LOVELAND15SCTO,29,73,-44,-152%
22-02-2016,59381,IRIS14SKLBTX,30,72,-42,-140%
12-02-2015,62875,PARKCITY15CTO1,49,42,7,14%
02-02-2015,199,PARTS,52,87,-35,-67%
03-07-2017,56744,MARBLE FALLS14BTX,75,81,-6,-8%
02-10-2016,199,PARTS,89,92,-3,-3%
02-01-2017,55725,CEDAR15HSWBTX,28,69,-41,-146%
23-03-2017,62881,LOVELAND14SBTX,92,27,65,71%
03-01-2016,56744,MARBLE FALLS14BTX,84,48,36,43%
16-06-2017,60825,BOLDPEAK2,3,31,-28,-933%
06-01-2015,56744,MARBLE FALLS14BTX,82,16,66,80%
24-08-2017,59379,IRIS14BSWBTX,68,43,25,37%
26-10-2016,62888,LOVELAND14FSCTO,26,52,-26,-100%
23-01-2015,60146,TULIP14BDWBTX,26,5,21,81%
28-11-2015,199,PARTS,34,93,-59,-174%
28-02-2017,199,PARTS,34,92,-58,-171%
25-08-2015,62877,LOVELAND14BBTX,2,26,-24,-1200%
25-09-2015,62881,LOVELAND14SBTX,81,76,5,6%
21-10-2016,56745,MARBLE FALLS15CTO,97,83,14,14%
06-03-2016,60705,VANGOGH15BDWBTX,7,25,-18,-257%
29-08-2017,60707,VANGOGH15SKLBTX,86,89,-3,-3%
30-01-2016,77845,PR31715LIVGSTONE,39,73,-34,-87%
29-06-2017,80401,PR53266MIRMAR15O,37,52,-15,-41%
28-08-2015,57455,TITAN14MLKBDWBTX,92,100,-8,-9%
01-09-2015,57453,JANUS15HSWBTX,83,16,67,81%
31-05-2015,60705,VANGOGH15BDWBTX,56,7,49,88%
03-03-2017,199,PARTS,63,58,5,8%
28-03-2016,199,PARTS,98,71,27,28%
10-05-2017,57497,GOLIADMLK14CTOE,80,3,77,96%
12-12-2017,199,PARTS,92,71,21,23%
15-11-2016,60153,TULIP15AMDBTX,71,94,-23,-32%
13-02-2017,57519,HOUSTON14BTX,33,73,-40,-121%
16-08-2016,57455,TITAN14MLKBDWBTX,95,52,43,45%
18-01-2015,57499,GOLIADMLK14BTXE,24,63,-39,-163%
20-06-2016,60705,VANGOGH15BDWBTX,73,83,-10,-14%
19-05-2017,72828,PR48813MAGELLXFR,85,45,40,47%
01-12-2015,57455,TITAN14MLKBDWBTX,82,45,37,45%
05-09-2017,57455,TITAN14MLKBDWBTX,2,22,-20,-1000%
26-11-2016,72484,PR48587ERIKSNATG,12,40,-28,-233%
15-01-2016,60147,TULIP15BDWBTX,23,30,-7,-30%
22-11-2016,76974,PR51319SALADO15,95,19,76,80%
21-04-2016,61341,MIRAMAR 17,12,6,6,50%
21-12-2016,57497,GOLIADMLK14CTOE,10,25,-15,-150%
27-07-2015,63886,PANDORA15SKLBTX,96,68,28,29%
21-09-2015,64248,JAYTONBTX,18,44,-26,-144%
24-09-2017,57191,ERIKSSON14CTO,15,59,-44,-293%
30-05-2017,57453,JANUS15HSWBTX,61,71,-10,-16%
14-05-2016,60151,TULIP17SKLBTX,100,94,6,6%
11-09-2015,61949,LIVINGSTONECTO,15,56,-41,-273%
16-12-2017,57519,HOUSTON14BTX,90,86,4,4%
21-08-2016,68337,ROUND ROCKMLKBTX,50,13,37,74%
03-12-2016,60150,TULIP15SKLBTX,97,7,90,93%
31-12-2015,59861,SILVEROAKBTX,97,89,8,8%
14-04-2017,62878,LOVELAND14BCTO,49,84,-35,-71%
05-05-2015,64248,JAYTONBTX,93,77,16,17%
26-01-2016,60705,VANGOGH15BDWBTX,51,9,42,82%
16-09-2017,199,PARTS,30,32,-2,-7%
10-03-2015,62877,LOVELAND14BBTX,83,82,1,1%
07-10-2016,57519,HOUSTON14BTX,86,17,69,80%
18-07-2016,57499,GOLIADMLK14BTXE,78,89,-11,-14%
03-07-2015,57499,GOLIADMLK14BTXE,73,32,41,56%
15-09-2016,57617,CRESTED BUTTECTO,6,46,-40,-667%
20-07-2015,57519,HOUSTON14BTX,64,26,38,59%
19-09-2017,62878,LOVELAND14BCTO,36,19,17,47%
16-06-2017,60705,VANGOGH15BDWBTX,70,65,5,7%
18-11-2017,59861,SILVEROAKBTX,95,59,36,38%
12-05-2015,57519,HOUSTON14BTX,94,31,63,67%
16-02-2015,62856,PARKCITY15BTX,85,42,43,51%
05-03-2017,56746,MARBLE FALLS15BTX,6,5,1,17%
02-07-2015,60812,VENENOBTX,64,33,31,48%
18-01-2016,61949,LIVINGSTONECTO,86,58,28,33%
06-05-2015,57519,HOUSTON14BTX,71,81,-10,-14%
11-07-2016,68343,ROUNDROCKMLKCTO1,60,22,38,63%
26-07-2015,52332,SALADO14BTX,46,88,-42,-91%
09-05-2017,57190,ERIKSSON14BTX,96,16,80,83%
17-08-2017,57453,JANUS15HSWBTX,18,68,-50,-278%
07-11-2017,76928,PR51297DIESEL17,40,14,26,65%
25-08-2016,76953,PR51154GOL14MLKO,49,25,24,49%
19-09-2017,57519,HOUSTON14BTX,60,62,-2,-3%
11-06-2016,60812,VENENOBTX,63,32,31,49%
06-03-2015,62857,PARKCITY15CTO,53,17,36,68%
03-02-2015,53512,GOLIAD 14,2,29,-27,-1350%
25-07-2017,57519,HOUSTON14BTX,38,23,15,39%
23-08-2017,60148,TULIP17BDWBTX,98,18,80,82%
08-11-2016,59384,IRIS15BDWBTX,5,45,-40,-800%
11-08-2017,59381,IRIS14SKLBTX,60,25,35,58%
07-05-2016,199,PARTS,60,54,6,10%
11-11-2017,63251,BLACKWOODSKLBTX,18,95,-77,-428%
04-05-2015,63039,PARKCITY-P15CTO,5,30,-25,-500%
07-09-2015,199,PARTS,33,85,-52,-158%
19-07-2015,60147,TULIP15BDWBTX,79,9,70,89%
21-04-2016,67528,PRMARBLEFALLS141,58,59,-1,-2%
02-09-2017,59861,SILVEROAKBTX,42,17,25,60%
30-10-2016,79092,PR52461CRESBUTEA,53,49,4,8%
11-10-2015,199,PARTS,37,9,28,76%
28-11-2016,57498,GOLIADMLK14TAAE,89,40,49,55%
08-05-2016,52370,SALADO 14,67,40,27,40%
28-01-2017,80398,PR53207GO14MLKAE,49,12,37,76%
11-03-2016,61590,DINO2BTX,71,20,51,72%
16-10-2017,62881,LOVELAND14SBTX,11,18,-7,-64%
13-05-2015,60812,VENENOBTX,94,36,58,62%
01-07-2016,60149,TULIP14SKLBTX,52,79,-27,-52%
10-05-2017,199,PARTS,43,99,-56,-130%
16-07-2015,60813,BERLINETTABTX,73,68,5,7%
17-03-2016,63251,BLACKWOODSKLBTX,96,29,67,70%
12-02-2017,199,PARTS,2,11,-9,-450%
05-10-2017,68337,ROUND ROCKMLKBTX,91,7,84,92%
26-04-2017,61341,MIRAMAR 17,9,76,-67,-744%
07-06-2016,68337,ROUND ROCKMLKBTX,22,100,-78,-355%
12-04-2015,62907,BEAVERCREEK14BTX,60,87,-27,-45%
29-11-2016,56858,PANDORA14HSWBTX,52,66,-14,-27%
14-11-2017,36028,SKIPPER,86,3,83,97%
08-08-2016,61239,REDWOODMLKBSWBTX,86,67,19,22%
24-08-2016,57525,HOUSTON15BTX,48,5,43,90%
07-01-2016,36028,SKIPPER,37,25,12,32%
13-10-2017,66803,SOMERSETBTX,45,96,-51,-113%
05-04-2015,61339,MIRAMAR 15,70,19,51,73%
02-02-2015,57513,HOUSTON12BTX,95,92,3,3%
05-12-2016,56744,MARBLE FALLS14BTX,49,45,4,8%
26-07-2016,62880,LOVELAND15SCTO,40,79,-39,-98%
13-01-2015,62878,LOVELAND14BCTO,64,64,0,0%
08-08-2015,59380,IRIS14BDWBTX,19,59,-40,-211%
05-07-2016,52333,SALADO15BTX,43,37,6,14%
03-07-2017,57495,GOLIADMLK12CTOE,71,13,58,82%
30-06-2015,57521,HOUSTON14CTO,23,71,-48,-209%
09-01-2016,199,PARTS,79,54,25,32%
08-10-2015,57525,HOUSTON15BTX,93,79,14,15%
25-01-2015,73788,PR49580DIESEL15,27,97,-70,-259%
03-12-2017,63251,BLACKWOODSKLBTX,89,36,53,60%
29-03-2015,61341,MIRAMAR 17,40,34,6,15%
07-05-2016,57637,FOXGLOVEBTX,62,38,24,39%
24-09-2015,79727,PR52754DIESEL15,68,3,65,96%
14-05-2017,68337,ROUND ROCKMLKBTX,63,8,55,87%
17-09-2016,53291,DIESEL 15,78,26,52,67%
07-03-2016,57190,ERIKSSON14BTX,97,74,23,24%
11-08-2015,62850,PARKCITY12BTX,4,88,-84,-2100%
11-03-2015,70901,ROCKET11BSWBTX,96,62,34,35%
27-04-2016,62908,BEAVERCREEK14CTO,4,62,-58,-1450%
10-06-2016,57525,HOUSTON15BTX,31,96,-65,-210%
01-02-2017,62853,PARKCITY14BTX,89,4,85,96%
25-10-2016,199,PARTS,97,78,19,20%
10-06-2017,57525,HOUSTON15BTX,80,40,40,50%
31-03-2015,199,PARTS,25,55,-30,-120%
13-08-2016,57495,GOLIADMLK12CTOE,73,56,17,23%
24-07-2016,51420,VIKING,16,50,-34,-213%
19-02-2015,52371,SALADO 15,50,68,-18,-36%
12-10-2015,74360,IRIS15AMDBTX,62,72,-10,-16%
13-09-2015,56745,MARBLE FALLS15CTO,67,52,15,22%
15-11-2015,85651,PR56629JAYTON,86,29,57,66%
17-12-2017,84017,PR48092BOLDPEAK2,28,73,-45,-161%
04-03-2016,68337,ROUND ROCKMLKBTX,82,87,-5,-6%
01-09-2015,63399,ECHO 17 MLK CTO,30,72,-42,-140%
19-04-2016,62850,PARKCITY12BTX,61,6,55,90%
01-07-2016,81231,PR53870COLUMXFR,83,59,24,29%
07-06-2015,199,PARTS,99,47,52,53%
30-09-2017,59380,IRIS14BDWBTX,88,44,44,50%
29-03-2017,68337,ROUND ROCKMLKBTX,24,17,7,29%
01-06-2015,80111,PR46265GOLI14MLK,24,44,-20,-83%
19-03-2016,73537,PR49254TESTAROP,62,81,-19,-31%
22-05-2015,57617,CRESTED BUTTECTO,97,11,86,89%
05-07-2017,55758,MAPLEM15BDWBTX,52,46,6,12%
16-11-2015,57515,HOUSTON12CTO,99,89,10,10%
05-03-2016,199,PARTS,82,35,47,57%
31-10-2015,61590,DINO2BTX,31,19,12,39%
08-05-2015,57523,HOUSTON14TAA,22,76,-54,-245%
16-02-2016,57284,REDWOODHSWBTX,82,99,-17,-21%
17-09-2017,68337,ROUND ROCKMLKBTX,70,79,-9,-13%
24-08-2017,57284,REDWOODHSWBTX,31,42,-11,-35%
16-09-2017,57515,HOUSTON12CTO,25,71,-46,-184%
28-06-2016,73810,PR43339GOLI14MLK,43,96,-53,-123%
27-12-2015,52371,SALADO 15,56,41,15,27%
23-02-2015,199,PARTS,77,63,14,18%
08-11-2015,60813,BERLINETTABTX,63,10,53,84%
21-02-2015,473,NON_TIED_PERIPHERALS,95,90,5,5%
14-05-2017,71895,PR48149LIVNGSTON,98,26,72,73%
25-05-2016,59380,IRIS14BDWBTX,69,64,5,7%
30-09-2015,60146,TULIP14BDWBTX,99,63,36,36%
14-10-2017,59380,IRIS14BDWBTX,59,43,16,27%
31-12-2015,59380,IRIS14BDWBTX,14,74,-60,-429%
26-05-2016,55832,JANUS14AMDBTX,9,91,-82,-911%
26-02-2015,59385,IRIS15SKLBTX,48,65,-17,-35%
20-05-2017,62851,PARKCITY12CTO,77,9,68,88%
11-06-2017,75065,PR50127SILVERTON,82,80,2,2%
07-01-2016,68570,PR46374HOUSTN14A,54,56,-2,-4%
16-08-2017,56745,MARBLE FALLS15CTO,73,20,53,73%
08-09-2017,57284,REDWOODHSWBTX,67,34,33,49%
25-04-2017,473,NON_TIED_PERIPHERALS,71,57,14,20%
16-05-2016,56746,MARBLE FALLS15BTX,82,46,36,44%
06-03-2015,59380,IRIS14BDWBTX,7,3,4,57%
26-06-2016,53542,ALPINE 15,45,61,-16,-36%
16-03-2016,53542,ALPINE 15,67,80,-13,-19%
11-12-2016,199,PARTS,58,82,-24,-41%
05-02-2017,62881,LOVELAND14SBTX,28,84,-56,-200%
25-03-2017,60146,TULIP14BDWBTX,34,60,-26,-76%
20-08-2016,57498,GOLIADMLK14TAAE,26,50,-24,-92%
07-03-2017,55758,MAPLEM15BDWBTX,77,55,22,29%
13-02-2015,199,PARTS,73,5,68,93%
09-09-2015,60151,TULIP17SKLBTX,46,78,-32,-70%
06-11-2016,57514,HOUSTON12CTOE,13,37,-24,-185%
29-07-2017,77334,PR51524GOL14MLKO,69,76,-7,-10%
20-07-2016,63395,ECHO 13 MLK CTO,43,85,-42,-98%
22-06-2015,57494,GOLIADMLK12BTXE,99,12,87,88%
21-03-2015,59380,IRIS14BDWBTX,69,53,16,23%
09-02-2016,56746,MARBLE FALLS15BTX,21,85,-64,-305%
03-10-2016,199,PARTS,48,45,3,6%
08-08-2016,52371,SALADO 15,32,51,-19,-59%
15-07-2017,61590,DINO2BTX,58,86,-28,-48%
06-01-2017,57368,FIGTREECTO,62,59,3,5%
13-05-2015,63886,PANDORA15SKLBTX,26,22,4,15%
21-10-2017,56745,MARBLE FALLS15CTO,90,78,12,13%
12-11-2016,62904,BEAVERCREEK12BTX,39,37,2,5%
20-03-2015,62877,LOVELAND14BBTX,54,45,9,17%
24-09-2016,62904,BEAVERCREEK12BTX,47,82,-35,-74%
04-05-2015,62854,PARKCITY14CTO,50,40,10,20%
16-05-2016,59381,IRIS14SKLBTX,40,70,-30,-75%
22-10-2017,80764,PR53609GO14MLKOE,89,81,8,9%
03-08-2016,83992,PR55366SALADO15,4,72,-68,-1700%
15-10-2016,61239,REDWOODMLKBSWBTX,30,92,-62,-207%
13-06-2015,57617,CRESTED BUTTECTO,56,58,-2,-4%
18-09-2016,199,PARTS,32,22,10,31%
21-03-2016,62884,LOVELAND15SBTX,54,19,35,65%
08-02-2017,62853,PARKCITY14BTX,79,82,-3,-4%
27-05-2017,83044,PR54771BERLINTAP,27,90,-63,-233%
12-09-2016,56746,MARBLE FALLS15BTX,31,64,-33,-106%
28-09-2015,63886,PANDORA15SKLBTX,1,2,-1,-100%
17-03-2015,59380,IRIS14BDWBTX,47,13,34,72%
07-10-2016,57527,HOUSTON15CTO,80,7,73,91%
03-02-2015,56745,MARBLE FALLS15CTO,1,5,-4,-400%
14-11-2015,62853,PARKCITY14BTX,19,4,15,79%
23-05-2016,59380,IRIS14BDWBTX,88,62,26,30%
17-01-2016,60704,VANGOGH14BDWBTX,87,17,70,80%
02-04-2017,60151,TULIP17SKLBTX,88,22,66,75%
30-10-2015,57521,HOUSTON14CTO,97,24,73,75%
13-08-2016,56745,MARBLE FALLS15CTO,78,4,74,95%
18-11-2016,52355,SALADO14TAA1,27,25,2,7%
27-10-2017,36029,SLINKY,56,53,3,5%
26-10-2016,80903,PR40886PRKCTY12,59,71,-12,-20%
20-07-2015,59380,IRIS14BDWBTX,7,41,-34,-486%
30-04-2015,62853,PARKCITY14BTX,94,44,50,53%
03-11-2017,199,PARTS,72,59,13,18%
12-04-2015,62853,PARKCITY14BTX,95,25,70,74%
24-01-2016,62884,LOVELAND15SBTX,29,93,-64,-221%
16-10-2015,57514,HOUSTON12CTOE,50,63,-13,-26%
30-05-2015,199,PARTS,42,36,6,14%
08-06-2017,61239,REDWOODMLKBSWBTX,13,65,-52,-400%
01-05-2015,199,PARTS,80,66,14,18%
20-01-2017,57527,HOUSTON15CTO,21,94,-73,-348%
07-02-2017,70901,ROCKET11BSWBTX,1,70,-69,-6900%
15-11-2017,68338,ROUND ROCKMLKCTO,62,21,41,66%
11-06-2016,62853,PARKCITY14BTX,65,83,-18,-28%
25-09-2015,62882,LOVELAND14SCTO,82,33,49,60%
19-08-2015,57494,GOLIADMLK12BTXE,89,77,12,13%
28-05-2017,68338,ROUND ROCKMLKCTO,76,55,21,28%
02-12-2015,62853,PARKCITY14BTX,20,32,-12,-60%
07-01-2016,57494,GOLIADMLK12BTXE,98,72,26,27%
26-12-2016,59380,IRIS14BDWBTX,10,74,-64,-640%
10-11-2015,62904,BEAVERCREEK12BTX,97,66,31,32%
30-05-2016,66803,SOMERSETBTX,21,71,-50,-238%
01-01-2017,63886,PANDORA15SKLBTX,69,94,-25,-36%
31-07-2016,59380,IRIS14BDWBTX,52,100,-48,-92%
01-12-2016,57494,GOLIADMLK12BTXE,83,14,69,83%
22-08-2015,63886,PANDORA15SKLBTX,85,68,17,20%
08-07-2017,52332,SALADO14BTX,24,34,-10,-42%
02-11-2015,65308,BLACKWELLT4BTX,23,38,-15,-65%
03-06-2016,199,PARTS,87,38,49,56%
29-05-2017,62854,PARKCITY14CTO,35,75,-40,-114%
05-11-2015,62853,PARKCITY14BTX,35,6,29,83%
05-10-2017,53512,GOLIAD 14,77,70,7,9%
19-01-2017,199,PARTS,56,72,-16,-29%
21-08-2016,62853,PARKCITY14BTX,80,89,-9,-11%
20-01-2015,60822,BOLDPEAK2BTX,57,81,-24,-42%
01-04-2015,57495,GOLIADMLK12CTOE,67,51,16,24%
02-09-2016,80788,PR53391LVELND15B,52,65,-13,-25%
01-07-2016,62853,PARKCITY14BTX,20,74,-54,-270%
22-10-2016,62908,BEAVERCREEK14CTO,55,61,-6,-11%
03-04-2017,62881,LOVELAND14SBTX,18,18,0,0%
26-06-2017,64248,JAYTONBTX,84,38,46,55%
18-01-2015,199,PARTS,30,49,-19,-63%
14-04-2017,62853,PARKCITY14BTX,41,92,-51,-124%
10-10-2015,62882,LOVELAND14SCTO,23,69,-46,-200%
19-09-2015,63886,PANDORA15SKLBTX,29,100,-71,-245%
06-03-2016,72168,PR48340CRESBUTEA,92,57,35,38%
18-05-2015,60812,VENENOBTX,15,45,-30,-200%
15-05-2016,61339,MIRAMAR 15,31,26,5,16%
08-12-2017,57523,HOUSTON14TAA,41,23,18,44%
23-12-2017,59380,IRIS14BDWBTX,72,53,19,26%
02-06-2017,53850,DIESEL15CTO,67,74,-7,-10%
07-06-2016,199,PARTS,43,78,-35,-81%
20-07-2017,57497,GOLIADMLK14CTOE,19,50,-31,-163%
26-11-2015,63886,PANDORA15SKLBTX,64,2,62,97%
21-11-2017,69923,CELTICBTX,59,36,23,39%
16-12-2015,70901,ROCKET11BSWBTX,3,54,-51,-1700%
30-06-2015,199,PARTS,70,74,-4,-6%
11-11-2015,60813,BERLINETTABTX,65,34,31,48%
14-11-2016,70901,ROCKET11BSWBTX,87,19,68,78%
24-01-2016,61333,BERLINETTA P,73,36,37,51%
15-04-2016,57515,HOUSTON12CTO,66,100,-34,-52%
24-09-2017,62853,PARKCITY14BTX,13,49,-36,-277%
20-10-2017,199,PARTS,89,82,7,8%
22-01-2017,57617,CRESTED BUTTECTO,71,49,22,31%
06-01-2015,199,PARTS,89,43,46,52%
16-07-2015,52371,SALADO 15,91,31,60,66%
24-08-2017,56745,MARBLE FALLS15CTO,45,71,-26,-58%
10-11-2016,60150,TULIP15SKLBTX,71,36,35,49%
12-07-2015,62851,PARKCITY12CTO,35,80,-45,-129%
08-08-2017,61239,REDWOODMLKBSWBTX,97,96,1,1%
12-01-2017,199,PARTS,97,94,3,3%
01-03-2016,73137,PR49109MAGELLXFR,68,1,67,99%
14-10-2016,61590,DINO2BTX,30,57,-27,-90%
05-03-2017,32575,BRUTUS,54,3,51,94%
07-10-2017,57494,GOLIADMLK12BTXE,98,95,3,3%
09-12-2016,68338,ROUND ROCKMLKCTO,74,87,-13,-18%
06-03-2015,60813,BERLINETTABTX,21,42,-21,-100%
23-03-2016,36028,SKIPPER,24,30,-6,-25%
30-04-2015,199,PARTS,79,92,-13,-16%
01-07-2015,199,PARTS,42,31,11,26%
31-07-2017,60150,TULIP15SKLBTX,70,11,59,84%
11-09-2017,199,PARTS,38,69,-31,-82%
19-10-2015,199,PARTS,57,18,39,68%
07-06-2017,52370,SALADO 14,13,4,9,69%
19-03-2017,61239,REDWOODMLKBSWBTX,26,97,-71,-273%
19-08-2016,59379,IRIS14BSWBTX,20,39,-19,-95%
03-04-2015,61590,DINO2BTX,73,79,-6,-8%
12-07-2017,60704,VANGOGH14BDWBTX,43,100,-57,-133%
06-09-2015,61590,DINO2BTX,33,21,12,36%
16-01-2015,72839,PR48856SALADO15,71,94,-23,-32%
16-07-2016,62883,LOVELAND15BCTO,22,13,9,41%
01-11-2017,57495,GOLIADMLK12CTOE,57,11,46,81%
30-11-2016,59383,IRIS15BSWBTX,84,56,28,33%
03-08-2017,62856,PARKCITY15BTX,39,8,31,79%
23-10-2016,61590,DINO2BTX,34,89,-55,-162%
08-12-2015,57494,GOLIADMLK12BTXE,42,13,29,69%
19-04-2016,59380,IRIS14BDWBTX,10,11,-1,-10%
12-03-2017,61341,MIRAMAR 17,60,83,-23,-38%
27-08-2016,199,PARTS,34,15,19,56%
09-07-2017,83031,PR54890PRKCTY12O,28,99,-71,-254%
20-08-2017,199,PARTS,32,27,5,16%
02-09-2016,59380,IRIS14BDWBTX,86,65,21,24%
17-11-2016,62856,PARKCITY15BTX,94,58,36,38%
15-06-2016,61590,DINO2BTX,38,19,19,50%
16-11-2016,199,PARTS,67,43,24,36%
17-03-2016,57515,HOUSTON12CTO,54,67,-13,-24%
22-01-2016,60813,BERLINETTABTX,45,16,29,64%
01-08-2017,52370,SALADO 14,100,75,25,25%
07-07-2016,57515,HOUSTON12CTO,3,28,-25,-833%
07-07-2015,61590,DINO2BTX,56,89,-33,-59%
17-07-2017,57495,GOLIADMLK12CTOE,63,15,48,76%
04-10-2017,61590,DINO2BTX,21,14,7,33%
31-08-2017,62856,PARKCITY15BTX,6,75,-69,-1150%
31-07-2015,56745,MARBLE FALLS15CTO,76,64,12,16%
16-07-2016,64248,JAYTONBTX,48,16,32,67%
04-07-2016,62907,BEAVERCREEK14BTX,20,33,-13,-65%
08-09-2016,61590,DINO2BTX,46,30,16,35%
28-08-2016,61590,DINO2BTX,15,20,-5,-33%
02-07-2016,56743,MARBLE FALLS14CTO,20,8,12,60%
18-09-2016,199,PARTS,28,72,-44,-157%
10-12-2016,199,PARTS,76,76,0,0%
12-11-2016,54142,TESTAROSSA P,76,77,-1,-1%
26-06-2015,199,PARTS,76,54,22,29%
17-04-2015,199,PARTS,59,50,9,15%
09-12-2016,199,PARTS,77,45,32,42%
11-07-2016,60813,BERLINETTABTX,90,79,11,12%
22-04-2015,60813,BERLINETTABTX,73,54,19,26%
20-04-2015,199,PARTS,11,91,-80,-727%
13-08-2017,62907,BEAVERCREEK14BTX,81,74,7,9%
07-02-2015,57494,GOLIADMLK12BTXE,84,53,31,37%
03-11-2015,61590,DINO2BTX,4,23,-19,-475%
19-02-2017,199,PARTS,58,45,13,22%
28-04-2016,61590,DINO2BTX,47,45,2,4%
09-02-2016,62856,PARKCITY15BTX,16,30,-14,-88%
18-05-2017,62907,BEAVERCREEK14BTX,66,24,42,64%
31-12-2015,65308,BLACKWELLT4BTX,83,35,48,58%
14-06-2016,81764,PR54098HOUSTN15A,91,16,75,82%
15-11-2015,61590,DINO2BTX,56,46,10,18%
04-09-2017,60704,VANGOGH14BDWBTX,40,45,-5,-13%
08-04-2016,199,PARTS,93,58,35,38%
02-01-2016,64248,JAYTONBTX,39,92,-53,-136%
14-11-2015,63886,PANDORA15SKLBTX,94,46,48,51%
30-05-2017,52332,SALADO14BTX,40,42,-2,-5%
22-09-2016,56517,REDWOODBTX,94,73,21,22%
15-03-2017,64250,JAYTONSECUREBTX,98,3,95,97%
27-04-2017,59384,IRIS15BDWBTX,23,39,-16,-70%
18-04-2015,57521,HOUSTON14CTO,77,84,-7,-9%
02-01-2016,62853,PARKCITY14BTX,22,9,13,59%
29-12-2017,57497,GOLIADMLK14CTOE,80,4,76,95%
27-03-2017,73929,DRAXBTX,73,9,64,88%
02-07-2016,60813,BERLINETTABTX,80,52,28,35%
22-04-2016,62854,PARKCITY14CTO,86,96,-10,-12%
24-02-2017,62907,BEAVERCREEK14BTX,38,3,35,92%
10-01-2016,56517,REDWOODBTX,63,88,-25,-40%
29-07-2017,60813,BERLINETTABTX,31,60,-29,-94%
04-02-2017,68338,ROUND ROCKMLKCTO,97,67,30,31%
02-11-2015,57521,HOUSTON14CTO,86,5,81,94%
13-01-2015,62907,BEAVERCREEK14BTX,20,37,-17,-85%
01-10-2016,62880,LOVELAND15SCTO,25,82,-57,-228%
10-08-2017,56743,MARBLE FALLS14CTO,78,94,-16,-21%
21-12-2017,56517,REDWOODBTX,28,82,-54,-193%
03-11-2016,53638,TESTAROSSA XPS BTX,37,55,-18,-49%
24-04-2016,62907,BEAVERCREEK14BTX,91,57,34,37%
02-03-2016,57617,CRESTED BUTTECTO,37,39,-2,-5%
15-12-2016,60146,TULIP14BDWBTX,41,74,-33,-80%
24-08-2016,73929,DRAXBTX,20,3,17,85%
13-05-2016,52332,SALADO14BTX,87,86,1,1%
18-07-2017,52332,SALADO14BTX,80,27,53,66%
02-02-2017,56517,REDWOODBTX,30,22,8,27%
15-10-2016,61590,DINO2BTX,100,3,97,97%
14-04-2017,62907,BEAVERCREEK14BTX,94,51,43,46%
20-03-2016,60151,TULIP17SKLBTX,22,24,-2,-9%
21-02-2017,56743,MARBLE FALLS14CTO,62,24,38,61%
21-08-2017,59379,IRIS14BSWBTX,37,91,-54,-146%
01-11-2015,32575,BRUTUS,89,37,52,58%
29-11-2016,199,PARTS,36,3,33,92%
20-05-2016,56744,MARBLE FALLS14BTX,58,50,8,14%
04-03-2017,57519,HOUSTON14BTX,90,83,7,8%
09-04-2017,60813,BERLINETTABTX,34,57,-23,-68%
31-03-2015,63399,ECHO 17 MLK CTO,10,75,-65,-650%
31-12-2016,57519,HOUSTON14BTX,56,96,-40,-71%
05-04-2015,57617,CRESTED BUTTECTO,71,75,-4,-6%
26-10-2017,199,PARTS,96,31,65,68%
26-04-2017,59380,IRIS14BDWBTX,56,4,52,93%
10-01-2017,60707,VANGOGH15SKLBTX,98,24,74,76%
02-09-2017,59380,IRIS14BDWBTX,5,85,-80,-1600%
09-12-2016,62907,BEAVERCREEK14BTX,34,80,-46,-135%
25-03-2016,59380,IRIS14BDWBTX,100,21,79,79%
11-01-2017,60146,TULIP14BDWBTX,21,70,-49,-233%
19-12-2016,57515,HOUSTON12CTO,6,93,-87,-1450%
27-10-2016,69925,CELTICCTO,61,50,11,18%
21-03-2017,57519,HOUSTON14BTX,11,58,-47,-427%
04-08-2016,60146,TULIP14BDWBTX,92,4,88,96%
05-12-2016,57499,GOLIADMLK14BTXE,44,22,22,50%
22-09-2017,62890,LOVELAND15FSCTO,32,66,-34,-106%
23-04-2017,60147,TULIP15BDWBTX,55,40,15,27%
26-08-2015,56744,MARBLE FALLS14BTX,57,49,8,14%
03-10-2017,57616,CRESTED BUTTEBTX,54,49,5,9%
03-07-2016,62857,PARKCITY15CTO,26,35,-9,-35%
13-07-2015,62876,PARKCITY15TAA1,95,18,77,81%
23-01-2015,62907,BEAVERCREEK14BTX,67,26,41,61%
20-01-2017,66803,SOMERSETBTX,35,85,-50,-143%
15-05-2016,56746,MARBLE FALLS15BTX,24,13,11,46%
10-11-2016,57631,MAPLE15AMDBTX,28,34,-6,-21%
06-05-2017,77347,PR51434SALADO14,87,22,65,75%
11-03-2017,60147,TULIP15BDWBTX,95,25,70,74%
02-06-2017,62851,PARKCITY12CTO,99,50,49,49%
30-01-2017,57519,HOUSTON14BTX,73,83,-10,-14%
04-07-2017,57519,HOUSTON14BTX,63,63,0,0%
24-07-2016,199,PARTS,59,20,39,66%
02-01-2016,199,PARTS,91,6,85,93%
23-04-2017,199,PARTS,80,22,58,73%
25-05-2017,62853,PARKCITY14BTX,47,75,-28,-60%
10-09-2017,57617,CRESTED BUTTECTO,97,26,71,73%
25-09-2017,57519,HOUSTON14BTX,12,56,-44,-367%
29-03-2015,55758,MAPLEM15BDWBTX,95,52,43,45%
04-09-2017,55758,MAPLEM15BDWBTX,32,30,2,6%
18-05-2015,59383,IRIS15BSWBTX,97,91,6,6%
07-02-2015,57513,HOUSTON12BTX,46,25,21,46%
18-05-2017,57519,HOUSTON14BTX,31,83,-52,-168%
11-11-2015,60146,TULIP14BDWBTX,72,98,-26,-36%
05-10-2016,57519,HOUSTON14BTX,41,52,-11,-27%
08-07-2017,57366,FIGTREEBTX,97,12,85,88%
25-02-2017,57374,FIGTREETAA1,46,40,6,13%
29-11-2016,57453,JANUS15HSWBTX,24,79,-55,-229%
06-06-2015,60704,VANGOGH14BDWBTX,55,87,-32,-58%
21-08-2016,59380,IRIS14BDWBTX,36,54,-18,-50%
29-09-2015,57494,GOLIADMLK12BTXE,88,83,5,6%
22-06-2016,57374,FIGTREETAA1,22,61,-39,-177%
28-04-2015,54983,ROUND ROCK,48,84,-36,-75%
14-02-2016,59380,IRIS14BDWBTX,35,73,-38,-109%
07-02-2016,62878,LOVELAND14BCTO,59,27,32,54%
27-09-2015,60707,VANGOGH15SKLBTX,64,91,-27,-42%
11-06-2017,57366,FIGTREEBTX,98,44,54,55%
16-07-2015,199,PARTS,75,75,0,0%
13-09-2017,57494,GOLIADMLK12BTXE,96,30,66,69%
02-06-2017,70901,ROCKET11BSWBTX,66,95,-29,-44%
02-12-2016,56746,MARBLE FALLS15BTX,77,6,71,92%
21-03-2017,57366,FIGTREEBTX,58,19,39,67%
22-07-2016,55758,MAPLEM15BDWBTX,59,75,-16,-27%
05-07-2015,199,PARTS,3,7,-4,-133%
13-08-2016,55758,MAPLEM15BDWBTX,23,3,20,87%
18-10-2017,199,PARTS,8,12,-4,-50%
11-12-2015,52371,SALADO 15,71,15,56,79%
05-09-2016,56746,MARBLE FALLS15BTX,10,89,-79,-790%
08-05-2015,62880,LOVELAND15SCTO,73,20,53,73%
19-05-2016,52371,SALADO 15,66,40,26,39%
06-05-2016,59380,IRIS14BDWBTX,2,47,-45,-2250%
12-07-2017,62857,PARKCITY15CTO,80,68,12,15%
07-10-2017,59380,IRIS14BDWBTX,63,48,15,24%
03-05-2016,57519,HOUSTON14BTX,58,38,20,34%
28-08-2015,36029,SLINKY,7,23,-16,-229%
29-08-2017,70901,ROCKET11BSWBTX,64,31,33,52%
07-02-2015,199,PARTS,45,93,-48,-107%
08-02-2015,57495,GOLIADMLK12CTOE,3,67,-64,-2133%
28-11-2015,63886,PANDORA15SKLBTX,6,20,-14,-233%
11-10-2016,68338,ROUND ROCKMLKCTO,13,65,-52,-400%
20-05-2016,85653,PR56489JYTNSETAA,79,7,72,91%
23-08-2015,63095,MERIDIANBTX,24,93,-69,-288%
15-01-2016,62881,LOVELAND14SBTX,31,43,-12,-39%
21-05-2017,66803,SOMERSETBTX,72,67,5,7%
08-01-2015,56743,MARBLE FALLS14CTO,38,29,9,24%
26-12-2017,60147,TULIP15BDWBTX,47,29,18,38%
31-12-2016,57497,GOLIADMLK14CTOE,10,95,-85,-850%
17-02-2015,57519,HOUSTON14BTX,83,74,9,11%
09-01-2015,62877,LOVELAND14BBTX,66,57,9,14%
31-12-2015,62907,BEAVERCREEK14BTX,81,43,38,47%
26-08-2016,56743,MARBLE FALLS14CTO,57,7,50,88%
02-11-2017,62856,PARKCITY15BTX,94,66,28,30%
22-01-2017,199,PARTS,71,29,42,59%
23-07-2015,62876,PARKCITY15TAA1,81,44,37,46%
14-04-2017,59380,IRIS14BDWBTX,76,8,68,89%
06-09-2015,62908,BEAVERCREEK14CTO,65,70,-5,-8%
26-09-2016,57529,HOUSTON15TAA,43,70,-27,-63%
02-09-2017,57191,ERIKSSON14CTO,27,55,-28,-104%
31-05-2017,60153,TULIP15AMDBTX,100,60,40,40%
20-12-2016,36029,SLINKY,98,83,15,15%
06-07-2017,57624,CRESTEDBUTTETAA1,46,23,23,50%
21-01-2015,57521,HOUSTON14CTO,50,66,-16,-32%
22-12-2016,60150,TULIP15SKLBTX,27,31,-4,-15%
29-11-2015,62907,BEAVERCREEK14BTX,12,18,-6,-50%
10-11-2016,52332,SALADO14BTX,99,83,16,16%
01-12-2017,62904,BEAVERCREEK12BTX,80,57,23,29%
10-10-2015,57455,TITAN14MLKBDWBTX,33,11,22,67%
28-11-2017,64250,JAYTONSECUREBTX,65,99,-34,-52%
27-12-2016,66803,SOMERSETBTX,88,84,4,5%
15-12-2016,62907,BEAVERCREEK14BTX,29,61,-32,-110%
09-08-2017,62907,BEAVERCREEK14BTX,74,89,-15,-20%
13-08-2017,63253,REDWOODSKLBTX,28,48,-20,-71%
23-06-2016,62907,BEAVERCREEK14BTX,32,72,-40,-125%
22-12-2016,57197,ERIKSSON14CTO1,31,71,-40,-129%
11-09-2017,62857,PARKCITY15CTO,80,5,75,94%
25-12-2015,62907,BEAVERCREEK14BTX,64,36,28,44%
04-02-2016,57521,HOUSTON14CTO,66,1,65,98%
12-05-2017,62907,BEAVERCREEK14BTX,31,83,-52,-168%
17-05-2017,62907,BEAVERCREEK14BTX,15,83,-68,-453%
21-06-2017,60705,VANGOGH15BDWBTX,70,70,0,0%
09-03-2017,64248,JAYTONBTX,34,51,-17,-50%
13-12-2015,199,PARTS,50,41,9,18%
11-09-2015,62907,BEAVERCREEK14BTX,80,46,34,43%
01-08-2016,57366,FIGTREEBTX,4,41,-37,-925%
08-10-2016,56746,MARBLE FALLS15BTX,45,15,30,67%
20-08-2017,62889,LOVELAND15FBBTX,24,99,-75,-313%
01-06-2016,84806,PR55863RNDRCKMLK,74,65,9,12%
02-05-2016,62856,PARKCITY15BTX,36,50,-14,-39%
15-01-2016,53516,GOLIAD12TAA,40,46,-6,-15%
13-11-2016,75369,PR50337SALADO14,1,53,-52,-5200%
27-06-2015,199,PARTS,28,68,-40,-143%
18-11-2016,62907,BEAVERCREEK14BTX,63,2,61,97%
13-02-2017,79979,PR52907PLANOB,56,100,-44,-79%
05-03-2015,62877,LOVELAND14BBTX,26,61,-35,-135%
12-03-2016,72168,PR48340CRESBUTEA,13,56,-43,-331%
24-02-2015,61590,DINO2BTX,13,79,-66,-508%
18-11-2017,62907,BEAVERCREEK14BTX,2,79,-77,-3850%
17-07-2015,62856,PARKCITY15BTX,91,54,37,41%
21-11-2016,55724,CEDAR14HSWBTX,52,38,14,27%
01-03-2017,62904,BEAVERCREEK12BTX,36,19,17,47%
07-01-2015,62856,PARKCITY15BTX,79,99,-20,-25%
06-04-2015,62907,BEAVERCREEK14BTX,5,4,1,20%
01-09-2017,62907,BEAVERCREEK14BTX,41,7,34,83%
17-01-2015,57617,CRESTED BUTTECTO,6,13,-7,-117%
16-04-2015,53292,DIESEL 17,70,2,68,97%
22-04-2017,55724,CEDAR14HSWBTX,17,49,-32,-188%
21-06-2017,57497,GOLIADMLK14CTOE,89,30,59,66%
26-06-2016,62853,PARKCITY14BTX,55,18,37,67%
08-10-2016,60153,TULIP15AMDBTX,35,34,1,3%
09-03-2015,62875,PARKCITY15CTO1,61,16,45,74%
23-01-2015,53512,GOLIAD 14,57,64,-7,-12%
01-12-2016,62907,BEAVERCREEK14BTX,23,90,-67,-291%
07-08-2017,62907,BEAVERCREEK14BTX,59,14,45,76%
14-03-2015,56744,MARBLE FALLS14BTX,82,19,63,77%
26-03-2017,57616,CRESTED BUTTEBTX,32,93,-61,-191%
23-06-2017,74192,DRAXSKLYBTX,30,50,-20,-67%
11-02-2015,57283,COTTONWOODBDWBTX,41,86,-45,-110%
14-06-2016,60147,TULIP15BDWBTX,72,26,46,64%
06-06-2016,55757,MAPLEM14BDWBTX,13,92,-79,-608%
10-12-2016,62907,BEAVERCREEK14BTX,2,45,-43,-2150%
28-06-2016,61590,DINO2BTX,8,12,-4,-50%
02-11-2015,199,PARTS,34,2,32,94%
28-09-2017,62853,PARKCITY14BTX,27,47,-20,-74%
30-04-2016,57519,HOUSTON14BTX,64,76,-12,-19%
24-01-2016,62907,BEAVERCREEK14BTX,19,96,-77,-405%
09-05-2015,199,PARTS,54,85,-31,-57%
20-02-2016,57521,HOUSTON14CTO,64,54,10,16%
22-05-2017,55757,MAPLEM14BDWBTX,75,61,14,19%
31-10-2015,61590,DINO2BTX,40,64,-24,-60%
08-01-2015,52370,SALADO 14,49,77,-28,-57%
01-01-2016,61341,MIRAMAR 17,49,59,-10,-20%
09-03-2015,56746,MARBLE FALLS15BTX,29,84,-55,-190%
15-01-2016,62907,BEAVERCREEK14BTX,64,50,14,22%
09-06-2015,63256,COTTONWOODSKLBTX,40,33,7,18%
16-07-2015,57494,GOLIADMLK12BTXE,88,78,10,11%
20-01-2016,52370,SALADO 14,30,36,-6,-20%
13-12-2017,61590,DINO2BTX,54,45,9,17%
28-05-2016,62853,PARKCITY14BTX,37,14,23,62%
25-04-2016,59379,IRIS14BSWBTX,58,28,30,52%
16-12-2016,57494,GOLIADMLK12BTXE,24,67,-43,-179%
20-12-2016,199,PARTS,35,7,28,80%
23-03-2016,62907,BEAVERCREEK14BTX,45,35,10,22%
04-12-2015,62880,LOVELAND15SCTO,46,46,0,0%
21-12-2017,62907,BEAVERCREEK14BTX,90,81,9,10%
23-10-2016,62905,BEAVERCREEK12CTO,28,16,12,43%
01-05-2015,61341,MIRAMAR 17,38,37,1,3%
11-05-2016,53301,DIESEL15GREYFED,69,12,57,83%
04-09-2017,61590,DINO2BTX,41,12,29,71%
05-05-2017,473,NON_TIED_PERIPHERALS,48,76,-28,-58%
22-03-2015,32577,CLOVER,10,39,-29,-290%
31-01-2017,76933,PR51250DIESEL17,79,24,55,70%
24-03-2017,61173,JASBSW20BTX,65,44,21,32%
01-07-2015,62907,BEAVERCREEK14BTX,63,86,-23,-37%
30-07-2015,66803,SOMERSETBTX,19,27,-8,-42%
02-06-2015,199,PARTS,15,5,10,67%
28-01-2017,57283,COTTONWOODBDWBTX,90,1,89,99%
26-01-2017,62850,PARKCITY12BTX,57,4,53,93%
31-05-2016,62879,LOVELAND15BBTX,35,51,-16,-46%
15-05-2015,57283,COTTONWOODBDWBTX,94,71,23,24%
08-02-2016,62853,PARKCITY14BTX,80,68,12,15%
31-07-2017,74521,PR49604ERIKSNATG,80,65,15,19%
07-03-2016,57525,HOUSTON15BTX,68,29,39,57%
19-02-2016,60146,TULIP14BDWBTX,17,21,-4,-24%
11-05-2016,57494,GOLIADMLK12BTXE,66,48,18,27%
02-01-2015,62853,PARKCITY14BTX,64,49,15,23%
18-01-2017,57527,HOUSTON15CTO,16,32,-16,-100%
14-11-2016,63394,ECHO 13 MLK BTX,8,89,-81,-1013%
28-02-2017,61590,DINO2BTX,65,78,-13,-20%
10-02-2015,61239,REDWOODMLKBSWBTX,18,13,5,28%
01-07-2017,62853,PARKCITY14BTX,12,83,-71,-592%
08-03-2015,32577,CLOVER,44,66,-22,-50%
25-08-2016,53850,DIESEL15CTO,48,32,16,33%
08-11-2016,62851,PARKCITY12CTO,59,22,37,63%
29-11-2017,61949,LIVINGSTONECTO,17,10,7,41%
12-12-2016,60705,VANGOGH15BDWBTX,27,24,3,11%
04-07-2017,199,PARTS,17,89,-72,-424%
26-10-2015,70901,ROCKET11BSWBTX,71,77,-6,-8%
19-11-2015,199,PARTS,40,51,-11,-28%
07-07-2016,32577,CLOVER,69,62,7,10%
07-08-2015,57283,COTTONWOODBDWBTX,24,65,-41,-171%
04-02-2016,52370,SALADO 14,46,43,3,7%
15-07-2015,63394,ECHO 13 MLK BTX,56,12,44,79%
13-12-2015,68338,ROUND ROCKMLKCTO,22,59,-37,-168%
10-04-2017,62879,LOVELAND15BBTX,71,35,36,51%
10-06-2017,65308,BLACKWELLT4BTX,25,40,-15,-60%
01-10-2017,62884,LOVELAND15SBTX,35,62,-27,-77%
20-06-2016,57519,HOUSTON14BTX,64,28,36,56%
11-07-2016,60706,VANGOGH14SKLBTX,59,88,-29,-49%
24-10-2017,62884,LOVELAND15SBTX,21,6,15,71%
25-09-2017,55724,CEDAR14HSWBTX,71,76,-5,-7%
09-12-2017,52370,SALADO 14,98,44,54,55%
01-03-2017,60705,VANGOGH15BDWBTX,2,30,-28,-1400%
29-01-2015,60148,TULIP17BDWBTX,3,12,-9,-300%
22-11-2015,199,PARTS,32,42,-10,-31%
07-11-2016,61341,MIRAMAR 17,83,58,25,30%
26-09-2017,32577,CLOVER,74,65,9,12%
02-02-2015,199,PARTS,48,2,46,96%
16-08-2017,62850,PARKCITY12BTX,65,30,35,54%
16-08-2015,65308,BLACKWELLT4BTX,83,86,-3,-4%
01-12-2015,56745,MARBLE FALLS15CTO,89,92,-3,-3%
26-04-2015,61949,LIVINGSTONECTO,78,52,26,33%
22-05-2015,199,PARTS,75,40,35,47%
17-01-2016,62908,BEAVERCREEK14CTO,4,68,-64,-1600%
24-10-2017,58167,ECHO 17 CTO,55,84,-29,-53%
06-06-2016,65308,BLACKWELLT4BTX,94,20,74,79%
12-12-2015,72810,PR48900CRESBUTEO,51,61,-10,-20%
06-11-2015,199,PARTS,40,1,39,98%
21-02-2017,57190,ERIKSSON14BTX,26,32,-6,-23%
09-06-2015,199,PARTS,13,66,-53,-408%
15-08-2016,199,PARTS,37,83,-46,-124%
23-06-2016,62907,BEAVERCREEK14BTX,6,67,-61,-1017%
30-06-2016,62884,LOVELAND15SBTX,83,65,18,22%
23-12-2015,59794,EAGLEPEAKBTX,82,75,7,9%
01-12-2015,52333,SALADO15BTX,96,10,86,90%
01-04-2017,62853,PARKCITY14BTX,15,90,-75,-500%
22-07-2015,60153,TULIP15AMDBTX,88,87,1,1%
05-03-2017,61239,REDWOODMLKBSWBTX,12,38,-26,-217%
24-06-2016,52333,SALADO15BTX,26,4,22,85%
20-09-2015,76871,PR51088JEFFERSON,26,48,-22,-85%
08-10-2017,60706,VANGOGH14SKLBTX,26,79,-53,-204%
15-01-2016,51433,VIKING CTO,71,5,66,93%
30-05-2015,62850,PARKCITY12BTX,90,92,-2,-2%
07-04-2017,56745,MARBLE FALLS15CTO,15,38,-23,-153%
14-10-2015,60813,BERLINETTABTX,31,23,8,26%
09-10-2017,52332,SALADO14BTX,84,1,83,99%
10-11-2016,72810,PR48900CRESBUTEO,72,47,25,35%
13-01-2016,199,PARTS,52,16,36,69%
23-10-2015,61333,BERLINETTA P,56,81,-25,-45%
21-07-2016,62853,PARKCITY14BTX,2,60,-58,-2900%
17-09-2017,65308,BLACKWELLT4BTX,98,55,43,44%
30-11-2016,199,PARTS,74,2,72,97%
08-10-2015,60707,VANGOGH15SKLBTX,58,20,38,66%
03-02-2016,199,PARTS,93,93,0,0%
16-07-2017,62856,PARKCITY15BTX,28,44,-16,-57%
29-07-2015,199,PARTS,54,27,27,50%
20-09-2015,68337,ROUND ROCKMLKBTX,51,3,48,94%
02-10-2016,60705,VANGOGH15BDWBTX,78,49,29,37%
05-01-2015,60704,VANGOGH14BDWBTX,86,18,68,79%
01-09-2016,57617,CRESTED BUTTECTO,43,16,27,63%
01-08-2016,60147,TULIP15BDWBTX,82,43,39,48%
04-02-2015,60150,TULIP15SKLBTX,9,87,-78,-867%
22-01-2016,52371,SALADO 15,80,19,61,76%
23-10-2016,199,PARTS,52,5,47,90%
12-01-2016,60147,TULIP15BDWBTX,57,33,24,42%
28-05-2017,60150,TULIP15SKLBTX,5,51,-46,-920%
15-03-2015,57368,FIGTREECTO,94,84,10,11%
21-10-2015,60147,TULIP15BDWBTX,75,57,18,24%
27-01-2017,70524,PRGOLIADMLK123,48,81,-33,-69%
04-09-2016,62877,LOVELAND14BBTX,39,90,-51,-131%
27-03-2017,59379,IRIS14BSWBTX,51,2,49,96%
03-12-2016,199,PARTS,97,61,36,37%
13-12-2015,69923,CELTICBTX,25,73,-48,-192%
25-10-2016,65308,BLACKWELLT4BTX,68,76,-8,-12%
05-07-2016,199,PARTS,79,91,-12,-15%
15-04-2016,57617,CRESTED BUTTECTO,24,27,-3,-13%
20-05-2015,60813,BERLINETTABTX,48,49,-1,-2%
24-10-2017,52332,SALADO14BTX,81,86,-5,-6%
12-12-2016,62881,LOVELAND14SBTX,72,30,42,58%
26-12-2017,60147,TULIP15BDWBTX,59,41,18,31%
16-09-2016,60147,TULIP15BDWBTX,93,19,74,80%
18-05-2016,199,PARTS,71,93,-22,-31%
31-03-2016,62881,LOVELAND14SBTX,70,54,16,23%
17-04-2015,62850,PARKCITY12BTX,21,18,3,14%
20-02-2016,57527,HOUSTON15CTO,84,56,28,33%
07-02-2016,62881,LOVELAND14SBTX,9,90,-81,-900%
13-05-2015,57190,ERIKSSON14BTX,87,83,4,5%
21-10-2017,62853,PARKCITY14BTX,14,33,-19,-136%
23-03-2016,52332,SALADO14BTX,72,65,7,10%
02-11-2016,60147,TULIP15BDWBTX,98,86,12,12%
03-09-2017,62881,LOVELAND14SBTX,25,20,5,20%
04-11-2016,85189,PR56174PLANOM,12,6,6,50%
10-04-2017,55725,CEDAR15HSWBTX,44,20,24,55%
26-09-2015,199,PARTS,27,57,-30,-111%
03-08-2015,54983,ROUND ROCK,94,57,37,39%
05-08-2017,57190,ERIKSSON14BTX,46,84,-38,-83%
31-03-2016,62881,LOVELAND14SBTX,15,75,-60,-400%
14-12-2015,69923,CELTICBTX,98,11,87,89%
27-04-2016,57190,ERIKSSON14BTX,40,24,16,40%
19-10-2016,57499,GOLIADMLK14BTXE,44,75,-31,-70%
21-05-2015,53301,DIESEL15GREYFED,15,47,-32,-213%
09-07-2017,71168,PR47566GOL14MLKO,87,96,-9,-10%
07-09-2017,62882,LOVELAND14SCTO,46,93,-47,-102%
16-07-2016,55725,CEDAR15HSWBTX,9,28,-19,-211%
23-09-2016,60147,TULIP15BDWBTX,59,29,30,51%
20-01-2016,75368,PR50405RNDROCK,43,62,-19,-44%
25-11-2015,60706,VANGOGH14SKLBTX,65,76,-11,-17%
29-05-2016,57515,HOUSTON12CTO,21,14,7,33%
28-01-2015,62853,PARKCITY14BTX,64,45,19,30%
09-07-2015,57616,CRESTED BUTTEBTX,58,81,-23,-40%
27-03-2017,60147,TULIP15BDWBTX,100,90,10,10%
13-05-2015,52332,SALADO14BTX,48,46,2,4%
24-09-2017,70901,ROCKET11BSWBTX,16,40,-24,-150%
27-04-2017,56743,MARBLE FALLS14CTO,39,4,35,90%
22-04-2016,62878,LOVELAND14BCTO,18,7,11,61%
25-08-2017,60147,TULIP15BDWBTX,73,17,56,77%
09-06-2016,63256,COTTONWOODSKLBTX,99,35,64,65%
02-10-2016,57616,CRESTED BUTTEBTX,79,18,61,77%
08-10-2015,199,PARTS,21,21,0,0%
24-07-2016,62853,PARKCITY14BTX,53,87,-34,-64%
11-08-2016,60148,TULIP17BDWBTX,18,64,-46,-256%
31-12-2015,56745,MARBLE FALLS15CTO,75,6,69,92%
21-11-2015,57616,CRESTED BUTTEBTX,24,75,-51,-213%
13-07-2016,62878,LOVELAND14BCTO,89,77,12,13%
22-01-2017,64248,JAYTONBTX,65,81,-16,-25%
09-05-2015,62881,LOVELAND14SBTX,54,65,-11,-20%
31-07-2015,59384,IRIS15BDWBTX,62,77,-15,-24%
09-09-2016,60706,VANGOGH14SKLBTX,23,9,14,61%
24-04-2015,199,PARTS,49,27,22,45%
18-11-2017,57379,JEFFERSONBTX,67,32,35,52%
17-07-2015,199,PARTS,70,79,-9,-13%
18-08-2017,70901,ROCKET11BSWBTX,35,65,-30,-86%
18-07-2016,59383,IRIS15BSWBTX,25,85,-60,-240%
27-07-2017,60147,TULIP15BDWBTX,16,53,-37,-231%
13-03-2017,57527,HOUSTON15CTO,91,48,43,47%
21-01-2017,62856,PARKCITY15BTX,62,52,10,16%
01-07-2016,60147,TULIP15BDWBTX,41,35,6,15%
03-07-2015,68337,ROUND ROCKMLKBTX,86,2,84,98%
08-05-2015,76926,PR51307DIESEL17,28,14,14,50%
23-07-2015,70901,ROCKET11BSWBTX,39,99,-60,-154%
19-11-2017,57191,ERIKSSON14CTO,53,46,7,13%
20-08-2017,62877,LOVELAND14BBTX,17,58,-41,-241%
04-07-2017,83950,PR55357GO14MLKOE,72,47,25,35%
05-05-2017,62853,PARKCITY14BTX,63,19,44,70%
17-02-2016,57379,JEFFERSONBTX,84,12,72,86%
01-03-2015,61590,DINO2BTX,92,39,53,58%
11-06-2015,57515,HOUSTON12CTO,23,92,-69,-300%
07-10-2016,52371,SALADO 15,32,43,-11,-34%
22-08-2016,52332,SALADO14BTX,85,54,31,36%
15-10-2016,57616,CRESTED BUTTEBTX,56,69,-13,-23%
21-01-2017,70901,ROCKET11BSWBTX,36,20,16,44%
07-08-2017,57379,JEFFERSONBTX,3,58,-55,-1833%
10-06-2015,55725,CEDAR15HSWBTX,42,92,-50,-119%
28-10-2016,59384,IRIS15BDWBTX,5,87,-82,-1640%
06-04-2017,57637,FOXGLOVEBTX,43,60,-17,-40%
01-11-2016,57519,HOUSTON14BTX,20,34,-14,-70%
01-07-2015,57616,CRESTED BUTTEBTX,37,80,-43,-116%
18-04-2015,60706,VANGOGH14SKLBTX,72,18,54,75%
11-07-2015,59515,BELMONTBTX,19,5,14,74%
19-02-2016,60147,TULIP15BDWBTX,61,28,33,54%
07-03-2017,57497,GOLIADMLK14CTOE,25,45,-20,-80%
08-09-2015,70901,ROCKET11BSWBTX,59,81,-22,-37%
01-10-2017,64250,JAYTONSECUREBTX,71,27,44,62%
14-12-2016,60148,TULIP17BDWBTX,27,53,-26,-96%
11-03-2017,62884,LOVELAND15SBTX,86,2,84,98%
21-08-2016,53301,DIESEL15GREYFED,52,27,25,48%
25-11-2015,60812,VENENOBTX,93,76,17,18%
20-02-2016,52371,SALADO 15,59,94,-35,-59%
17-12-2016,60148,TULIP17BDWBTX,48,90,-42,-88%
22-01-2015,54983,ROUND ROCK,36,32,4,11%
10-01-2015,60706,VANGOGH14SKLBTX,60,18,42,70%
08-03-2017,57616,CRESTED BUTTEBTX,90,59,31,34%
24-03-2016,57519,HOUSTON14BTX,35,100,-65,-186%
03-07-2017,61339,MIRAMAR 15,72,16,56,78%
27-03-2015,60147,TULIP15BDWBTX,7,86,-79,-1129%
11-01-2015,55724,CEDAR14HSWBTX,71,77,-6,-8%
10-10-2016,73525,PR49293PLANOM,57,3,54,95%
17-11-2017,57525,HOUSTON15BTX,73,65,8,11%
21-04-2015,60147,TULIP15BDWBTX,57,68,-11,-19%
30-12-2016,62884,LOVELAND15SBTX,31,56,-25,-81%
01-01-2016,57616,CRESTED BUTTEBTX,28,55,-27,-96%
17-12-2016,60706,VANGOGH14SKLBTX,23,98,-75,-326%
27-06-2015,56744,MARBLE FALLS14BTX,18,72,-54,-300%
06-10-2017,57520,HOUSTON14CTOE,56,79,-23,-41%
30-06-2015,70901,ROCKET11BSWBTX,74,26,48,65%
08-10-2016,57616,CRESTED BUTTEBTX,11,66,-55,-500%
23-06-2016,60707,VANGOGH15SKLBTX,48,36,12,25%
21-01-2015,62904,BEAVERCREEK12BTX,61,60,1,2%
18-01-2015,57520,HOUSTON14CTOE,77,20,57,74%
21-01-2015,62883,LOVELAND15BCTO,39,90,-51,-131%
13-08-2016,62881,LOVELAND14SBTX,35,8,27,77%
22-04-2017,199,PARTS,87,59,28,32%
26-08-2017,57521,HOUSTON14CTO,64,89,-25,-39%
01-05-2015,68337,ROUND ROCKMLKBTX,4,47,-43,-1075%
26-05-2016,81907,PR47129LOVELNS14,49,73,-24,-49%
29-10-2017,62904,BEAVERCREEK12BTX,59,44,15,25%
19-03-2016,75570,PR50510DIESEL17,79,13,66,84%
16-09-2015,61341,MIRAMAR 17,79,1,78,99%
12-06-2015,199,PARTS,96,93,3,3%
18-10-2017,199,PARTS,1,15,-14,-1400%
19-12-2017,62908,BEAVERCREEK14CTO,11,15,-4,-36%
21-11-2016,63886,PANDORA15SKLBTX,90,74,16,18%
25-10-2016,61333,BERLINETTA P,35,26,9,26%
01-05-2016,60153,TULIP15AMDBTX,83,18,65,78%
06-09-2017,57519,HOUSTON14BTX,71,9,62,87%
13-10-2016,59384,IRIS15BDWBTX,82,64,18,22%
27-11-2015,60153,TULIP15AMDBTX,92,93,-1,-1%
11-09-2016,57616,CRESTED BUTTEBTX,97,52,45,46%
01-05-2017,53781,LATITUDE OAK15BTX,99,52,47,47%
01-04-2016,63253,REDWOODSKLBTX,47,74,-27,-57%
27-12-2016,199,PARTS,55,45,10,18%
31-03-2016,59860,SILVERTONBTX,51,6,45,88%
30-09-2016,56553,BRADLEYBDWBTX,86,71,15,17%
22-07-2017,60153,TULIP15AMDBTX,39,85,-46,-118%
01-10-2016,57519,HOUSTON14BTX,43,53,-10,-23%
29-12-2016,52333,SALADO15BTX,9,37,-28,-311%
13-09-2017,199,PARTS,6,73,-67,-1117%
31-07-2017,56151,MAGELLAN14CTO,73,77,-4,-5%
26-05-2017,62904,BEAVERCREEK12BTX,71,55,16,23%
06-06-2015,60150,TULIP15SKLBTX,22,94,-72,-327%
20-09-2016,59515,BELMONTBTX,13,9,4,31%
28-06-2015,60147,TULIP15BDWBTX,37,12,25,68%
09-03-2016,56743,MARBLE FALLS14CTO,73,12,61,84%
20-07-2017,62904,BEAVERCREEK12BTX,29,86,-57,-197%
28-10-2015,60150,TULIP15SKLBTX,87,8,79,91%
27-01-2017,60706,VANGOGH14SKLBTX,36,51,-15,-42%
23-04-2015,60153,TULIP15AMDBTX,65,95,-30,-46%
06-04-2015,68338,ROUND ROCKMLKCTO,37,64,-27,-73%
31-07-2016,62904,BEAVERCREEK12BTX,89,45,44,49%
02-11-2016,62904,BEAVERCREEK12BTX,44,72,-28,-64%
08-05-2015,73785,PR49455MARFALS14,22,25,-3,-14%
06-08-2015,62904,BEAVERCREEK12BTX,28,33,-5,-18%
27-09-2016,62904,BEAVERCREEK12BTX,38,15,23,61%
12-05-2016,67988,PR45972CRESBUTEA,6,95,-89,-1483%
30-06-2016,57494,GOLIADMLK12BTXE,73,31,42,58%
11-11-2015,68337,ROUND ROCKMLKBTX,79,2,77,97%
22-08-2015,62904,BEAVERCREEK12BTX,27,81,-54,-200%
07-01-2017,62904,BEAVERCREEK12BTX,43,39,4,9%
11-08-2017,63276,MAPLE15SKLBTX,70,46,24,34%
25-05-2017,74192,DRAXSKLYBTX,80,23,57,71%
21-02-2015,60148,TULIP17BDWBTX,54,25,29,54%
16-10-2017,53512,GOLIAD 14,71,34,37,52%
23-05-2016,63256,COTTONWOODSKLBTX,88,48,40,45%
03-03-2017,69925,CELTICCTO,29,49,-20,-69%
04-03-2016,59860,SILVERTONBTX,76,6,70,92%
12-01-2017,62904,BEAVERCREEK12BTX,60,68,-8,-13%
09-03-2015,53781,LATITUDE OAK15BTX,51,3,48,94%
18-04-2016,74124,PR49703ERIKSNATG,35,5,30,86%
14-07-2016,199,PARTS,62,79,-17,-27%
24-02-2016,53777,LATITUDE OAK14BTX,2,72,-70,-3500%
27-04-2016,199,PARTS,60,96,-36,-60%
21-03-2017,199,PARTS,47,93,-46,-98%
11-04-2015,199,PARTS,42,67,-25,-60%
14-08-2016,62904,BEAVERCREEK12BTX,24,49,-25,-104%
13-12-2016,63255,COTTONWOODBSKLBTX,19,39,-20,-105%
06-03-2016,60150,TULIP15SKLBTX,70,69,1,1%
13-02-2015,62904,BEAVERCREEK12BTX,83,71,12,14%
11-03-2016,60150,TULIP15SKLBTX,62,51,11,18%
11-03-2015,54142,TESTAROSSA P,40,40,0,0%
29-09-2015,62854,PARKCITY14CTO,75,3,72,96%
10-08-2015,60151,TULIP17SKLBTX,16,50,-34,-213%
06-05-2015,62907,BEAVERCREEK14BTX,89,23,66,74%
31-03-2017,64248,JAYTONBTX,26,43,-17,-65%
06-05-2017,60825,BOLDPEAK2,31,69,-38,-123%
06-08-2015,60812,VENENOBTX,78,45,33,42%
03-07-2017,63886,PANDORA15SKLBTX,1,94,-93,-9300%
19-12-2016,60150,TULIP15SKLBTX,53,34,19,36%
01-08-2015,199,PARTS,61,8,53,87%
13-01-2017,32577,CLOVER,83,97,-14,-17%
25-09-2016,59383,IRIS15BSWBTX,49,11,38,78%
09-07-2016,60150,TULIP15SKLBTX,49,63,-14,-29%
04-09-2015,63256,COTTONWOODSKLBTX,96,87,9,9%
28-10-2016,62883,LOVELAND15BCTO,71,78,-7,-10%
04-02-2017,62891,LOVELAND15FSBTX,53,57,-4,-8%
25-07-2017,62907,BEAVERCREEK14BTX,23,26,-3,-13%
02-03-2016,199,PARTS,88,97,-9,-10%
15-07-2016,199,PARTS,83,79,4,5%
08-05-2015,57190,ERIKSSON14BTX,76,38,38,50%
05-04-2015,60150,TULIP15SKLBTX,45,65,-20,-44%
03-11-2015,53510,GOLIAD 12,96,76,20,21%
30-12-2015,80401,PR53266MIRMAR15O,97,100,-3,-3%
26-01-2016,53779,LATITUDE OAK15,84,74,10,12%
03-08-2016,60150,TULIP15SKLBTX,88,46,42,48%
22-04-2016,1431,POWEREDGE,10,40,-30,-300%
17-09-2016,57495,GOLIADMLK12CTOE,84,13,71,85%
26-12-2017,60153,TULIP15AMDBTX,40,79,-39,-98%
05-07-2015,62905,BEAVERCREEK12CTO,26,20,6,23%
07-04-2016,59379,IRIS14BSWBTX,33,61,-28,-85%
28-08-2015,199,PARTS,86,64,22,26%
25-08-2017,60705,VANGOGH15BDWBTX,99,72,27,27%
17-07-2017,56151,MAGELLAN14CTO,44,38,6,14%
12-06-2015,69925,CELTICCTO,18,9,9,50%
14-03-2015,66803,SOMERSETBTX,9,14,-5,-56%
01-11-2015,60705,VANGOGH15BDWBTX,22,81,-59,-268%
27-02-2016,57515,HOUSTON12CTO,55,13,42,76%
11-01-2016,60705,VANGOGH15BDWBTX,1,33,-32,-3200%
26-04-2016,199,PARTS,11,93,-82,-745%
17-06-2015,60705,VANGOGH15BDWBTX,35,55,-20,-57%
12-08-2016,199,PARTS,42,72,-30,-71%
16-06-2015,62879,LOVELAND15BBTX,9,29,-20,-222%
15-04-2017,53850,DIESEL15CTO,31,90,-59,-190%
26-08-2017,62854,PARKCITY14CTO,14,33,-19,-136%
23-01-2017,62884,LOVELAND15SBTX,6,86,-80,-1333%
05-06-2015,1431,POWEREDGE,69,65,4,6%
11-10-2015,62856,PARKCITY15BTX,21,36,-15,-71%
07-03-2015,57513,HOUSTON12BTX,87,4,83,95%
30-09-2017,59380,IRIS14BDWBTX,72,64,8,11%
26-03-2015,62907,BEAVERCREEK14BTX,31,56,-25,-81%
25-11-2017,63095,MERIDIANBTX,48,92,-44,-92%
06-02-2017,62907,BEAVERCREEK14BTX,64,81,-17,-27%
25-10-2017,52332,SALADO14BTX,34,72,-38,-112%
27-08-2015,63886,PANDORA15SKLBTX,48,52,-4,-8%
25-12-2016,63886,PANDORA15SKLBTX,51,35,16,31%
26-07-2017,62853,PARKCITY14BTX,93,19,74,80%
22-12-2016,60153,TULIP15AMDBTX,85,26,59,69%
15-01-2016,62904,BEAVERCREEK12BTX,63,88,-25,-40%
12-06-2017,62907,BEAVERCREEK14BTX,42,43,-1,-2%
06-12-2017,199,PARTS,56,84,-28,-50%
03-11-2017,199,PARTS,53,39,14,26%
21-04-2017,45817,PARTS-SERVICE,40,41,-1,-3%
11-07-2015,63399,ECHO 17 MLK CTO,68,73,-5,-7%
16-08-2016,57453,JANUS15HSWBTX,40,34,6,15%
23-04-2016,52332,SALADO14BTX,45,19,26,58%
13-10-2017,60705,VANGOGH15BDWBTX,64,90,-26,-41%
29-09-2016,63255,COTTONWOODBSKLBTX,77,41,36,47%
23-07-2015,62907,BEAVERCREEK14BTX,87,43,44,51%
23-08-2017,63095,MERIDIANBTX,47,80,-33,-70%
24-02-2017,60704,VANGOGH14BDWBTX,35,94,-59,-169%
11-06-2017,62907,BEAVERCREEK14BTX,35,40,-5,-14%
28-02-2017,53291,DIESEL 15,26,38,-12,-46%
06-08-2017,62883,LOVELAND15BCTO,83,6,77,93%
13-03-2015,62911,BEAVERCREEK12FCTO,63,93,-30,-48%
01-03-2016,199,PARTS,24,82,-58,-242%
21-03-2017,55725,CEDAR15HSWBTX,52,78,-26,-50%
11-03-2017,77346,PR51415SALADO14,39,84,-45,-115%
26-06-2016,67623,MONET14SKLBTX,2,9,-7,-350%
01-05-2017,62850,PARKCITY12BTX,65,50,15,23%
29-05-2015,63253,REDWOODSKLBTX,18,9,9,50%
21-12-2015,63253,REDWOODSKLBTX,41,2,39,95%
17-11-2015,85743,PR56508PLANOB,34,67,-33,-97%
03-07-2017,199,PARTS,2,61,-59,-2950%
07-06-2015,62907,BEAVERCREEK14BTX,43,55,-12,-28%
07-04-2016,67623,MONET14SKLBTX,25,22,3,12%
31-07-2016,60147,TULIP15BDWBTX,84,76,8,10%
22-02-2017,59380,IRIS14BDWBTX,70,39,31,44%
13-12-2017,62856,PARKCITY15BTX,35,65,-30,-86%
09-11-2017,65308,BLACKWELLT4BTX,58,22,36,62%
01-12-2017,59384,IRIS15BDWBTX,96,2,94,98%
05-05-2017,57379,JEFFERSONBTX,71,1,70,99%
14-12-2017,67623,MONET14SKLBTX,63,55,8,13%
25-10-2016,57283,COTTONWOODBDWBTX,18,95,-77,-428%
21-05-2017,57527,HOUSTON15CTO,98,78,20,20%
18-03-2016,199,PARTS,54,93,-39,-72%
17-07-2016,57191,ERIKSSON14CTO,40,26,14,35%
15-03-2017,60705,VANGOGH15BDWBTX,87,100,-13,-15%
03-09-2016,62907,BEAVERCREEK14BTX,15,23,-8,-53%
01-12-2016,57521,HOUSTON14CTO,1,22,-21,-2100%
01-06-2015,62853,PARKCITY14BTX,61,47,14,23%
10-08-2015,55725,CEDAR15HSWBTX,35,69,-34,-97%
25-04-2017,53291,DIESEL 15,46,57,-11,-24%
16-12-2017,57523,HOUSTON14TAA,54,17,37,69%
27-03-2015,62851,PARKCITY12CTO,66,1,65,98%
28-06-2017,61341,MIRAMAR 17,63,48,15,24%
14-05-2016,63039,PARKCITY-P15CTO,42,64,-22,-52%
02-09-2015,77831,PR45417HOUSTON14,67,55,12,18%
13-01-2016,62856,PARKCITY15BTX,9,4,5,56%
10-06-2017,60706,VANGOGH14SKLBTX,79,60,19,24%
03-08-2015,62856,PARKCITY15BTX,55,25,30,55%
25-02-2016,68337,ROUND ROCKMLKBTX,30,73,-43,-143%
30-05-2015,62907,BEAVERCREEK14BTX,50,58,-8,-16%
03-03-2015,62856,PARKCITY15BTX,1,27,-26,-2600%
08-11-2017,68337,ROUND ROCKMLKBTX,90,21,69,77%
25-01-2017,199,PARTS,70,64,6,9%
27-07-2017,52370,SALADO 14,79,11,68,86%
26-06-2017,60151,TULIP17SKLBTX,54,21,33,61%
02-12-2017,60151,TULIP17SKLBTX,16,20,-4,-25%
04-06-2016,70901,ROCKET11BSWBTX,52,38,14,27%
09-03-2017,67623,MONET14SKLBTX,66,67,-1,-2%
14-09-2015,67623,MONET14SKLBTX,74,63,11,15%
26-09-2015,60151,TULIP17SKLBTX,77,69,8,10%
12-12-2016,60812,VENENOBTX,11,82,-71,-645%
13-09-2017,62857,PARKCITY15CTO,73,26,47,64%
24-12-2015,55725,CEDAR15HSWBTX,59,59,0,0%
31-08-2017,62907,BEAVERCREEK14BTX,69,37,32,46%
07-06-2016,60707,VANGOGH15SKLBTX,1,26,-25,-2500%
23-10-2016,62882,LOVELAND14SCTO,23,61,-38,-165%
13-03-2016,60147,TULIP15BDWBTX,47,49,-2,-4%
10-11-2016,69923,CELTICBTX,96,35,61,64%
30-05-2017,62856,PARKCITY15BTX,59,33,26,44%
27-12-2017,63256,COTTONWOODSKLBTX,41,71,-30,-73%
18-01-2016,62907,BEAVERCREEK14BTX,64,71,-7,-11%
29-03-2016,199,PARTS,35,73,-38,-109%
26-11-2015,63886,PANDORA15SKLBTX,95,79,16,17%
20-04-2015,199,PARTS,14,12,2,14%
17-11-2017,57527,HOUSTON15CTO,22,13,9,41%
19-06-2015,57497,GOLIADMLK14CTOE,81,87,-6,-7%
10-02-2015,62877,LOVELAND14BBTX,72,91,-19,-26%
01-07-2015,63886,PANDORA15SKLBTX,86,52,34,40%
25-06-2016,57515,HOUSTON12CTO,16,14,2,13%
02-10-2016,60149,TULIP14SKLBTX,50,90,-40,-80%
12-06-2016,62907,BEAVERCREEK14BTX,72,31,41,57%
12-09-2016,74496,PR49960LIVNGSTON,10,72,-62,-620%
04-01-2015,62888,LOVELAND14FSCTO,48,19,29,60%
24-11-2017,59379,IRIS14BSWBTX,51,10,41,80%
11-09-2017,63255,COTTONWOODBSKLBTX,87,86,1,1%
29-06-2017,199,PARTS,98,25,73,74%
01-12-2016,62880,LOVELAND15SCTO,71,15,56,79%
13-08-2017,199,PARTS,29,26,3,10%
14-08-2016,57191,ERIKSSON14CTO,82,69,13,16%
16-01-2015,63886,PANDORA15SKLBTX,8,32,-24,-300%
06-01-2016,72168,PR48340CRESBUTEA,5,51,-46,-920%
25-12-2015,61347,MIRAMAR15CTO,28,23,5,18%
20-07-2017,62856,PARKCITY15BTX,86,80,6,7%
29-01-2015,62904,BEAVERCREEK12BTX,41,72,-31,-76%
05-06-2015,60153,TULIP15AMDBTX,70,28,42,60%
26-08-2015,62907,BEAVERCREEK14BTX,67,37,30,45%
23-10-2015,66803,SOMERSETBTX,60,4,56,93%
13-06-2017,60704,VANGOGH14BDWBTX,13,32,-19,-146%
12-09-2016,60705,VANGOGH15BDWBTX,57,42,15,26%
16-03-2015,68337,ROUND ROCKMLKBTX,12,48,-36,-300%
12-09-2016,73533,PR49261SALADO15,28,13,15,54%
15-08-2017,63039,PARKCITY-P15CTO,10,16,-6,-60%
05-06-2015,62911,BEAVERCREEK12FCTO,11,70,-59,-536%
16-09-2017,56153,COLUMBUS12CTO,35,72,-37,-106%
08-12-2015,56746,MARBLE FALLS15BTX,26,74,-48,-185%
26-06-2017,52371,SALADO 15,62,41,21,34%
10-11-2015,53923,COLUMBUS12BTX,34,30,4,12%
10-10-2015,75366,PR50404HOUSTN14O,80,9,71,89%
31-07-2016,62907,BEAVERCREEK14BTX,87,23,64,74%
19-05-2017,61333,BERLINETTA P,100,10,90,90%
29-10-2016,77346,PR51415SALADO14,59,41,18,31%
03-03-2015,62882,LOVELAND14SCTO,15,7,8,53%
12-08-2015,59384,IRIS15BDWBTX,53,57,-4,-8%
08-04-2015,62907,BEAVERCREEK14BTX,69,40,29,42%
05-01-2016,57525,HOUSTON15BTX,92,44,48,52%
11-03-2015,60705,VANGOGH15BDWBTX,71,62,9,13%
23-01-2015,57191,ERIKSSON14CTO,79,6,73,92%
25-10-2015,62907,BEAVERCREEK14BTX,54,21,33,61%
13-05-2016,62856,PARKCITY15BTX,54,47,7,13%
20-09-2015,60147,TULIP15BDWBTX,100,75,25,25%
01-07-2017,60147,TULIP15BDWBTX,79,19,60,76%
27-03-2016,57453,JANUS15HSWBTX,24,100,-76,-317%
09-01-2016,199,PARTS,11,41,-30,-273%
12-03-2015,199,PARTS,14,81,-67,-479%
25-08-2016,62907,BEAVERCREEK14BTX,37,78,-41,-111%
18-12-2015,60151,TULIP17SKLBTX,59,38,21,36%
15-11-2015,68288,PR45105SALADO14Z,45,57,-12,-27%
17-06-2017,199,PARTS,59,60,-1,-2%
27-09-2015,63399,ECHO 17 MLK CTO,19,82,-63,-332%
30-01-2016,60147,TULIP15BDWBTX,4,47,-43,-1075%
03-03-2017,60151,TULIP17SKLBTX,54,30,24,44%
22-01-2016,62856,PARKCITY15BTX,72,34,38,53%
15-12-2017,70901,ROCKET11BSWBTX,62,26,36,58%
21-07-2015,62856,PARKCITY15BTX,20,13,7,35%
22-11-2016,62856,PARKCITY15BTX,68,2,66,97%
06-07-2015,53923,COLUMBUS12BTX,53,37,16,30%
14-11-2017,57521,HOUSTON14CTO,27,69,-42,-156%
14-09-2016,57515,HOUSTON12CTO,83,17,66,80%
08-06-2015,77472,PR32591HOUSTN12E,84,15,69,82%
24-05-2015,72502,PR47600RNDROCK2,16,53,-37,-231%
01-05-2017,63039,PARKCITY-P15CTO,59,94,-35,-59%
17-10-2016,62907,BEAVERCREEK14BTX,10,91,-81,-810%
17-07-2016,57515,HOUSTON12CTO,20,69,-49,-245%
22-12-2015,57374,FIGTREETAA1,24,57,-33,-138%
21-09-2015,60707,VANGOGH15SKLBTX,12,89,-77,-642%
29-08-2017,55725,CEDAR15HSWBTX,43,4,39,91%
13-01-2015,59383,IRIS15BSWBTX,28,62,-34,-121%
15-05-2016,57519,HOUSTON14BTX,12,9,3,25%
27-02-2017,60147,TULIP15BDWBTX,79,57,22,28%
14-05-2015,199,PARTS,6,4,2,33%
25-08-2015,62856,PARKCITY15BTX,71,74,-3,-4%
01-05-2016,57513,HOUSTON12BTX,76,64,12,16%
12-10-2016,66803,SOMERSETBTX,87,8,79,91%
16-08-2017,60705,VANGOGH15BDWBTX,2,54,-52,-2600%
13-06-2015,60151,TULIP17SKLBTX,89,64,25,28%
01-12-2015,62904,BEAVERCREEK12BTX,29,96,-67,-231%
14-08-2017,62908,BEAVERCREEK14CTO,44,38,6,14%
09-08-2016,57519,HOUSTON14BTX,58,44,14,24%
10-03-2015,60707,VANGOGH15SKLBTX,27,35,-8,-30%
13-04-2017,60825,BOLDPEAK2,90,28,62,69%
30-06-2017,199,PARTS,70,54,16,23%
02-03-2017,57525,HOUSTON15BTX,76,78,-2,-3%
21-02-2017,60150,TULIP15SKLBTX,65,58,7,11%
02-12-2016,60705,VANGOGH15BDWBTX,85,41,44,52%
29-01-2017,61347,MIRAMAR15CTO,25,97,-72,-288%
12-02-2017,57527,HOUSTON15CTO,41,34,7,17%
06-11-2017,53539,ALPINE 14,68,38,30,44%
23-01-2015,57527,HOUSTON15CTO,47,35,12,26%
16-09-2016,57519,HOUSTON14BTX,49,70,-21,-43%
27-03-2017,57515,HOUSTON12CTO,17,68,-51,-300%
23-12-2016,62884,LOVELAND15SBTX,63,95,-32,-51%
16-06-2016,52332,SALADO14BTX,13,71,-58,-446%
09-11-2016,55725,CEDAR15HSWBTX,7,78,-71,-1014%
19-07-2016,62904,BEAVERCREEK12BTX,84,74,10,12%
05-07-2016,63397,ECHO 15 MLK CTO,62,30,32,52%
01-02-2016,62907,BEAVERCREEK14BTX,98,45,53,54%
23-08-2017,59383,IRIS15BSWBTX,24,39,-15,-63%
01-12-2015,56744,MARBLE FALLS14BTX,14,93,-79,-564%
24-12-2016,60705,VANGOGH15BDWBTX,72,84,-12,-17%
20-08-2017,64248,JAYTONBTX,82,70,12,15%
10-03-2017,199,PARTS,40,18,22,55%
18-12-2015,55725,CEDAR15HSWBTX,48,94,-46,-96%
20-05-2015,80788,PR53391LVELND15B,74,81,-7,-9%
19-07-2015,60705,VANGOGH15BDWBTX,4,64,-60,-1500%
05-12-2016,199,PARTS,43,23,20,47%
09-07-2016,60151,TULIP17SKLBTX,75,53,22,29%
11-06-2016,199,PARTS,56,68,-12,-21%
03-07-2017,69923,CELTICBTX,68,45,23,34%
21-07-2017,57494,GOLIADMLK12BTXE,66,74,-8,-12%
02-02-2017,63256,COTTONWOODSKLBTX,41,25,16,39%
30-01-2016,63039,PARKCITY-P15CTO,96,64,32,33%
03-11-2017,60705,VANGOGH15BDWBTX,73,79,-6,-8%
01-04-2016,199,PARTS,10,49,-39,-390%
18-09-2017,59383,IRIS15BSWBTX,22,26,-4,-18%
22-10-2015,199,PARTS,100,99,1,1%
15-01-2015,60705,VANGOGH15BDWBTX,45,37,8,18%
11-07-2015,60705,VANGOGH15BDWBTX,72,89,-17,-24%
10-11-2017,60151,TULIP17SKLBTX,21,53,-32,-152%
15-07-2015,62856,PARKCITY15BTX,84,34,50,60%
18-11-2017,199,PARTS,35,36,-1,-3%
05-03-2015,68338,ROUND ROCKMLKCTO,32,59,-27,-84%
03-05-2015,61339,MIRAMAR 15,98,33,65,66%
22-06-2016,56151,MAGELLAN14CTO,22,11,11,50%
22-12-2015,57283,COTTONWOODBDWBTX,48,43,5,10%
26-01-2016,54142,TESTAROSSA P,61,78,-17,-28%
14-09-2017,60147,TULIP15BDWBTX,34,56,-22,-65%
03-04-2016,62907,BEAVERCREEK14BTX,98,15,83,85%
15-05-2015,63256,COTTONWOODSKLBTX,67,86,-19,-28%
26-03-2015,63256,COTTONWOODSKLBTX,31,31,0,0%
13-06-2016,59384,IRIS15BDWBTX,13,39,-26,-200%
17-01-2015,62878,LOVELAND14BCTO,77,72,5,6%
18-11-2017,62907,BEAVERCREEK14BTX,28,21,7,25%
23-11-2015,63256,COTTONWOODSKLBTX,37,95,-58,-157%
01-07-2017,59860,SILVERTONBTX,46,58,-12,-26%
28-06-2015,60705,VANGOGH15BDWBTX,66,31,35,53%
19-07-2017,57519,HOUSTON14BTX,57,12,45,79%
26-11-2016,62907,BEAVERCREEK14BTX,40,94,-54,-135%
01-05-2015,84387,PR47835BOLDPEAK2,86,48,38,44%
21-07-2015,62907,BEAVERCREEK14BTX,73,1,72,99%
04-05-2016,60705,VANGOGH15BDWBTX,11,67,-56,-509%
21-06-2015,60705,VANGOGH15BDWBTX,68,49,19,28%
27-11-2017,63256,COTTONWOODSKLBTX,23,40,-17,-74%
24-08-2017,74192,DRAXSKLYBTX,33,67,-34,-103%
20-11-2017,62856,PARKCITY15BTX,27,65,-38,-141%
09-05-2016,60151,TULIP17SKLBTX,66,79,-13,-20%
28-11-2016,59383,IRIS15BSWBTX,89,89,0,0%
11-02-2016,57191,ERIKSSON14CTO,63,96,-33,-52%
26-01-2017,56151,MAGELLAN14CTO,8,86,-78,-975%
04-04-2016,62850,PARKCITY12BTX,91,79,12,13%
10-03-2015,57497,GOLIADMLK14CTOE,56,56,0,0%
23-07-2015,60151,TULIP17SKLBTX,89,73,16,18%
01-05-2017,57616,CRESTED BUTTEBTX,98,23,75,77%
05-03-2017,199,PARTS,92,52,40,43%
27-08-2016,60705,VANGOGH15BDWBTX,90,40,50,56%
25-06-2016,62907,BEAVERCREEK14BTX,72,4,68,94%
28-07-2017,63886,PANDORA15SKLBTX,31,54,-23,-74%
09-12-2016,62878,LOVELAND14BCTO,76,50,26,34%
25-08-2017,70901,ROCKET11BSWBTX,86,18,68,79%
06-06-2016,199,PARTS,54,43,11,20%
25-05-2016,60705,VANGOGH15BDWBTX,94,6,88,94%
21-09-2016,61341,MIRAMAR 17,48,34,14,29%
15-02-2017,61347,MIRAMAR15CTO,72,82,-10,-14%
31-03-2017,62907,BEAVERCREEK14BTX,46,74,-28,-61%
14-08-2015,199,PARTS,57,85,-28,-49%
01-09-2016,62907,BEAVERCREEK14BTX,51,46,5,10%
18-09-2016,199,PARTS,1,91,-90,-9000%
24-04-2017,62907,BEAVERCREEK14BTX,94,50,44,47%
20-08-2017,53302,DIESEL17GREYFED,41,56,-15,-37%
23-08-2016,60705,VANGOGH15BDWBTX,24,83,-59,-246%
11-08-2015,62907,BEAVERCREEK14BTX,1,89,-88,-8800%
30-11-2016,199,PARTS,30,30,0,0%
14-12-2016,52375,SALADO 14 CTO,3,78,-75,-2500%
27-09-2016,52370,SALADO 14,29,16,13,45%
20-05-2015,60150,TULIP15SKLBTX,47,80,-33,-70%
14-01-2016,62907,BEAVERCREEK14BTX,10,85,-75,-750%
19-03-2015,63885,PANDORA15HSWBTX,6,16,-10,-167%
06-05-2017,199,PARTS,40,21,19,48%
18-03-2015,199,PARTS,23,69,-46,-200%
18-01-2017,62907,BEAVERCREEK14BTX,13,98,-85,-654%
18-08-2017,63256,COTTONWOODSKLBTX,82,92,-10,-12%
01-05-2016,52370,SALADO 14,82,65,17,21%
23-03-2016,62907,BEAVERCREEK14BTX,41,61,-20,-49%
05-08-2016,60705,VANGOGH15BDWBTX,11,57,-46,-418%
07-08-2015,53301,DIESEL15GREYFED,58,61,-3,-5%
17-06-2015,62907,BEAVERCREEK14BTX,76,24,52,68%
25-11-2017,199,PARTS,12,87,-75,-625%
18-10-2017,82228,PR54537BLACKWELL,58,75,-17,-29%
22-12-2016,62907,BEAVERCREEK14BTX,92,47,45,49%
04-04-2016,62907,BEAVERCREEK14BTX,28,78,-50,-179%
04-11-2015,62905,BEAVERCREEK12CTO,78,22,56,72%
17-12-2015,62907,BEAVERCREEK14BTX,92,8,84,91%
19-04-2017,62907,BEAVERCREEK14BTX,97,70,27,28%
19-12-2017,57497,GOLIADMLK14CTOE,16,16,0,0%
14-08-2015,62907,BEAVERCREEK14BTX,82,47,35,43%
19-06-2017,60150,TULIP15SKLBTX,86,1,85,99%
11-11-2015,199,PARTS,54,58,-4,-7%
02-07-2015,84799,PR55866PRKCTY14O,5,100,-95,-1900%
14-10-2017,199,PARTS,89,99,-10,-11%
08-08-2016,69779,PR47101GOL12MLKA,46,20,26,57%
07-08-2017,62907,BEAVERCREEK14BTX,17,42,-25,-147%
19-05-2015,62907,BEAVERCREEK14BTX,78,28,50,64%
30-04-2015,60705,VANGOGH15BDWBTX,53,76,-23,-43%
01-10-2017,62882,LOVELAND14SCTO,96,93,3,3%
02-02-2015,62857,PARKCITY15CTO,63,98,-35,-56%
17-02-2015,62907,BEAVERCREEK14BTX,41,16,25,61%
13-07-2017,64248,JAYTONBTX,10,69,-59,-590%
04-10-2015,59385,IRIS15SKLBTX,19,77,-58,-305%
16-02-2015,62879,LOVELAND15BBTX,81,18,63,78%
22-02-2015,62907,BEAVERCREEK14BTX,93,95,-2,-2%
28-09-2017,69923,CELTICBTX,85,47,38,45%
24-03-2016,62907,BEAVERCREEK14BTX,89,1,88,99%
06-01-2017,61590,DINO2BTX,4,55,-51,-1275%
03-10-2016,60705,VANGOGH15BDWBTX,88,66,22,25%
18-09-2015,57616,CRESTED BUTTEBTX,63,24,39,62%
01-10-2017,61590,DINO2BTX,16,81,-65,-406%
07-09-2016,61590,DINO2BTX,49,63,-14,-29%
23-06-2015,62907,BEAVERCREEK14BTX,47,27,20,43%
04-07-2016,69923,CELTICBTX,85,26,59,69%
29-12-2015,66803,SOMERSETBTX,6,36,-30,-500%
06-04-2017,69983,PR47219GOL12MLKA,39,12,27,69%
08-04-2016,60150,TULIP15SKLBTX,66,15,51,77%
08-01-2015,61590,DINO2BTX,16,18,-2,-13%
27-03-2017,69923,CELTICBTX,35,96,-61,-174%
28-06-2015,60705,VANGOGH15BDWBTX,38,96,-58,-153%
10-02-2017,54983,ROUND ROCK,72,91,-19,-26%
14-09-2015,61590,DINO2BTX,3,29,-26,-867%
25-04-2017,62907,BEAVERCREEK14BTX,60,87,-27,-45%
12-05-2015,58167,ECHO 17 CTO,37,100,-63,-170%
28-01-2015,62907,BEAVERCREEK14BTX,13,44,-31,-238%
19-05-2016,57527,HOUSTON15CTO,29,85,-56,-193%
29-05-2017,65308,BLACKWELLT4BTX,64,100,-36,-56%
25-07-2017,62907,BEAVERCREEK14BTX,71,2,69,97%
27-12-2017,199,PARTS,8,60,-52,-650%
22-04-2016,61590,DINO2BTX,34,57,-23,-68%
21-04-2017,69923,CELTICBTX,7,96,-89,-1271%
18-03-2017,62907,BEAVERCREEK14BTX,93,94,-1,-1%
13-11-2015,61590,DINO2BTX,89,40,49,55%
11-09-2016,63253,REDWOODSKLBTX,88,80,8,9%
10-03-2016,199,PARTS,4,70,-66,-1650%
13-10-2016,61590,DINO2BTX,20,56,-36,-180%
23-08-2015,60705,VANGOGH15BDWBTX,88,62,26,30%
21-09-2016,56746,MARBLE FALLS15BTX,97,1,96,99%
01-05-2016,56151,MAGELLAN14CTO,96,35,61,64%
15-03-2017,62907,BEAVERCREEK14BTX,72,91,-19,-26%
25-01-2017,61590,DINO2BTX,40,97,-57,-143%
23-10-2017,68338,ROUND ROCKMLKCTO,33,62,-29,-88%
14-02-2017,72785,PR48919DIESEL15,58,9,49,84%
28-03-2015,61590,DINO2BTX,57,24,33,58%
28-04-2015,62884,LOVELAND15SBTX,60,41,19,32%
14-03-2017,62907,BEAVERCREEK14BTX,50,84,-34,-68%
06-01-2016,57495,GOLIADMLK12CTOE,69,67,2,3%
03-05-2016,57527,HOUSTON15CTO,99,28,71,72%
11-11-2017,199,PARTS,9,13,-4,-44%
29-11-2016,62878,LOVELAND14BCTO,89,58,31,35%
01-05-2016,61590,DINO2BTX,8,99,-91,-1138%
27-12-2016,53301,DIESEL15GREYFED,29,28,1,3%
26-12-2017,62884,LOVELAND15SBTX,83,20,63,76%
17-03-2016,56746,MARBLE FALLS15BTX,21,91,-70,-333%
05-12-2017,60705,VANGOGH15BDWBTX,30,40,-10,-33%
05-10-2016,68337,ROUND ROCKMLKBTX,26,47,-21,-81%
20-05-2015,60704,VANGOGH14BDWBTX,9,45,-36,-400%
30-04-2016,60151,TULIP17SKLBTX,75,70,5,7%
19-11-2015,56151,MAGELLAN14CTO,53,16,37,70%
28-01-2017,57497,GOLIADMLK14CTOE,49,72,-23,-47%
13-02-2017,62856,PARKCITY15BTX,82,7,75,91%
24-04-2015,56746,MARBLE FALLS15BTX,41,9,32,78%
08-12-2016,60705,VANGOGH15BDWBTX,68,14,54,79%
26-08-2017,62857,PARKCITY15CTO,7,9,-2,-29%
19-08-2017,62856,PARKCITY15BTX,15,92,-77,-513%
19-02-2016,62907,BEAVERCREEK14BTX,6,1,5,83%
01-06-2016,473,NON_TIED_PERIPHERALS,65,87,-22,-34%
01-05-2016,56746,MARBLE FALLS15BTX,4,90,-86,-2150%
07-08-2015,62907,BEAVERCREEK14BTX,9,50,-41,-456%
15-07-2015,61590,DINO2BTX,95,73,22,23%
05-07-2015,59383,IRIS15BSWBTX,11,92,-81,-736%
27-06-2017,199,PARTS,48,12,36,75%
29-07-2017,61590,DINO2BTX,20,53,-33,-165%
19-06-2017,62884,LOVELAND15SBTX,69,41,28,41%
27-05-2015,61590,DINO2BTX,12,96,-84,-700%
29-10-2016,60812,VENENOBTX,77,33,44,57%
27-12-2015,56745,MARBLE FALLS15CTO,36,72,-36,-100%
31-10-2017,63885,PANDORA15HSWBTX,95,6,89,94%
27-12-2017,62884,LOVELAND15SBTX,72,88,-16,-22%
30-06-2016,199,PARTS,88,81,7,8%
12-02-2015,62907,BEAVERCREEK14BTX,93,12,81,87%
07-08-2017,199,PARTS,35,70,-35,-100%
13-01-2016,199,PARTS,100,63,37,37%
09-11-2017,61339,MIRAMAR 15,6,88,-82,-1367%
29-04-2016,199,PARTS,3,35,-32,-1067%
05-02-2016,61590,DINO2BTX,79,55,24,30%
04-10-2017,62907,BEAVERCREEK14BTX,23,6,17,74%
18-02-2016,62856,PARKCITY15BTX,31,73,-42,-135%
08-04-2015,60812,VENENOBTX,65,11,54,83%
02-05-2016,62856,PARKCITY15BTX,53,26,27,51%
25-10-2017,73381,PR37345GOLI12MLK,65,39,26,40%
31-01-2016,60812,VENENOBTX,9,84,-75,-833%
24-03-2017,63276,MAPLE15SKLBTX,86,2,84,98%
19-12-2016,63095,MERIDIANBTX,76,96,-20,-26%
18-02-2017,60151,TULIP17SKLBTX,68,35,33,49%
18-01-2015,52370,SALADO 14,62,64,-2,-3%
13-05-2016,64151,PR44102ERIKSNATG,12,20,-8,-67%
14-02-2016,62878,LOVELAND14BCTO,28,35,-7,-25%
05-09-2017,60705,VANGOGH15BDWBTX,14,27,-13,-93%
08-07-2017,62856,PARKCITY15BTX,19,87,-68,-358%
11-03-2015,62881,LOVELAND14SBTX,67,50,17,25%
19-10-2015,62853,PARKCITY14BTX,61,24,37,61%
14-11-2015,52370,SALADO 14,33,60,-27,-82%
29-12-2015,199,PARTS,24,62,-38,-158%
27-05-2017,62884,LOVELAND15SBTX,82,62,20,24%
20-09-2017,53301,DIESEL15GREYFED,67,25,42,63%
10-01-2016,60705,VANGOGH15BDWBTX,37,19,18,49%
24-03-2016,82695,PR41691LOVELNS15,10,26,-16,-160%
17-05-2017,63399,ECHO 17 MLK CTO,13,69,-56,-431%
21-11-2017,60150,TULIP15SKLBTX,28,48,-20,-71%
14-01-2016,56746,MARBLE FALLS15BTX,45,78,-33,-73%
04-03-2015,199,PARTS,100,45,55,55%
12-04-2016,56746,MARBLE FALLS15BTX,65,30,35,54%
07-08-2015,60150,TULIP15SKLBTX,16,58,-42,-263%
17-02-2016,63095,MERIDIANBTX,26,8,18,69%
01-03-2016,62911,BEAVERCREEK12FCTO,96,46,50,52%
06-11-2016,63276,MAPLE15SKLBTX,1,22,-21,-2100%
01-08-2016,60150,TULIP15SKLBTX,4,88,-84,-2100%
22-02-2015,60813,BERLINETTABTX,14,53,-39,-279%
21-09-2016,63276,MAPLE15SKLBTX,57,66,-9,-16%
23-09-2016,54983,ROUND ROCK,98,7,91,93%
29-08-2015,63253,REDWOODSKLBTX,90,96,-6,-7%
20-02-2016,62907,BEAVERCREEK14BTX,27,23,4,15%
27-06-2017,54984,ROUND ROCKBTX,41,48,-7,-17%
03-12-2016,60147,TULIP15BDWBTX,33,19,14,42%
02-02-2016,62884,LOVELAND15SBTX,86,73,13,15%
06-03-2015,56745,MARBLE FALLS15CTO,72,21,51,71%
17-12-2017,78239,PR51812LIVNGSTON,69,62,7,10%
09-04-2016,62853,PARKCITY14BTX,42,66,-24,-57%
29-10-2015,62856,PARKCITY15BTX,43,40,3,7%
27-10-2017,61173,JASBSW20BTX,85,78,7,8%
11-10-2015,199,PARTS,97,32,65,67%
13-01-2017,62853,PARKCITY14BTX,64,74,-10,-16%
01-11-2017,60150,TULIP15SKLBTX,72,83,-11,-15%
03-12-2016,62856,PARKCITY15BTX,13,68,-55,-423%
23-11-2015,52333,SALADO15BTX,22,8,14,64%
02-08-2016,60707,VANGOGH15SKLBTX,92,38,54,59%
08-04-2016,60707,VANGOGH15SKLBTX,99,4,95,96%
19-09-2015,199,PARTS,3,79,-76,-2533%
25-12-2016,60150,TULIP15SKLBTX,29,61,-32,-110%
10-07-2016,60705,VANGOGH15BDWBTX,83,3,80,96%
07-07-2017,62877,LOVELAND14BBTX,41,16,25,61%
21-12-2017,55724,CEDAR14HSWBTX,21,40,-19,-90%
03-03-2016,54984,ROUND ROCKBTX,50,80,-30,-60%
13-11-2017,57521,HOUSTON14CTO,3,33,-30,-1000%
01-02-2016,57190,ERIKSSON14BTX,1,6,-5,-500%
10-01-2015,60813,BERLINETTABTX,45,93,-48,-107%
05-01-2017,55758,MAPLEM15BDWBTX,79,98,-19,-24%
30-08-2017,62856,PARKCITY15BTX,45,78,-33,-73%
20-05-2016,59384,IRIS15BDWBTX,39,9,30,77%
03-07-2016,54984,ROUND ROCKBTX,85,74,11,13%
30-10-2015,61333,BERLINETTA P,69,79,-10,-14%
17-04-2015,62850,PARKCITY12BTX,55,16,39,71%
09-08-2017,62881,LOVELAND14SBTX,17,76,-59,-347%
22-11-2015,62853,PARKCITY14BTX,13,57,-44,-338%
18-06-2017,53775,LATITUDE OAK14,67,2,65,97%
02-07-2016,63256,COTTONWOODSKLBTX,37,86,-49,-132%
28-07-2016,62877,LOVELAND14BBTX,87,96,-9,-10%
09-04-2015,57455,TITAN14MLKBDWBTX,58,95,-37,-64%
04-08-2016,60705,VANGOGH15BDWBTX,3,87,-84,-2800%
14-07-2015,63886,PANDORA15SKLBTX,82,52,30,37%
19-08-2016,57190,ERIKSSON14BTX,32,88,-56,-175%
26-12-2017,199,PARTS,35,38,-3,-9%
26-05-2016,62856,PARKCITY15BTX,52,80,-28,-54%
24-12-2015,55725,CEDAR15HSWBTX,32,25,7,22%
24-08-2016,62857,PARKCITY15CTO,4,22,-18,-450%
15-02-2017,62882,LOVELAND14SCTO,88,38,50,57%
03-02-2017,55725,CEDAR15HSWBTX,98,51,47,48%
13-06-2015,61333,BERLINETTA P,26,48,-22,-85%
26-08-2016,57527,HOUSTON15CTO,87,52,35,40%
31-01-2017,68337,ROUND ROCKMLKBTX,13,52,-39,-300%
05-03-2015,62879,LOVELAND15BBTX,91,29,62,68%
02-10-2016,52370,SALADO 14,70,88,-18,-26%
05-03-2016,61590,DINO2BTX,90,42,48,53%
28-10-2016,57515,HOUSTON12CTO,20,27,-7,-35%
29-08-2015,53512,GOLIAD 14,49,55,-6,-12%
20-09-2017,60151,TULIP17SKLBTX,29,84,-55,-190%
05-09-2016,62908,BEAVERCREEK14CTO,30,59,-29,-97%
07-10-2015,60704,VANGOGH14BDWBTX,13,56,-43,-331%
25-02-2017,62850,PARKCITY12BTX,49,8,41,84%
11-07-2017,64248,JAYTONBTX,86,46,40,47%
05-11-2017,68708,PRHOUSTON14CTOE3,30,16,14,47%
25-07-2017,57190,ERIKSSON14BTX,62,19,43,69%
02-03-2015,57379,JEFFERSONBTX,96,11,85,89%
22-11-2015,57190,ERIKSSON14BTX,72,73,-1,-1%
15-10-2015,70901,ROCKET11BSWBTX,63,16,47,75%
22-09-2016,60705,VANGOGH15BDWBTX,23,55,-32,-139%
31-10-2016,199,PARTS,32,45,-13,-41%
05-03-2016,64248,JAYTONBTX,87,51,36,41%
23-12-2017,66803,SOMERSETBTX,24,91,-67,-279%
22-09-2016,57640,DINO13BTX,13,41,-28,-215%
15-11-2015,65308,BLACKWELLT4BTX,6,39,-33,-550%
06-10-2016,62881,LOVELAND14SBTX,92,27,65,71%
08-06-2015,62907,BEAVERCREEK14BTX,27,77,-50,-185%
21-10-2017,62907,BEAVERCREEK14BTX,19,27,-8,-42%
15-12-2015,62856,PARKCITY15BTX,78,85,-7,-9%
05-11-2015,57616,CRESTED BUTTEBTX,15,6,9,60%
19-04-2015,62850,PARKCITY12BTX,54,9,45,83%
08-06-2015,64250,JAYTONSECUREBTX,80,8,72,90%
02-11-2016,81749,PR54079CRESBUTEA,96,71,25,26%
05-06-2017,53291,DIESEL 15,43,83,-40,-93%
31-01-2015,63276,MAPLE15SKLBTX,99,47,52,53%
20-10-2015,62856,PARKCITY15BTX,38,49,-11,-29%
14-12-2015,199,PARTS,81,15,66,81%
09-01-2016,57497,GOLIADMLK14CTOE,70,26,44,63%
09-10-2017,63253,REDWOODSKLBTX,47,96,-49,-104%
05-11-2016,55725,CEDAR15HSWBTX,95,47,48,51%
25-08-2017,60705,VANGOGH15BDWBTX,84,20,64,76%
11-12-2016,62904,BEAVERCREEK12BTX,79,61,18,23%
25-10-2015,60147,TULIP15BDWBTX,99,17,82,83%
19-03-2015,57455,TITAN14MLKBDWBTX,38,89,-51,-134%
03-11-2017,52370,SALADO 14,42,70,-28,-67%
20-05-2016,66803,SOMERSETBTX,30,79,-49,-163%
06-08-2016,57455,TITAN14MLKBDWBTX,27,18,9,33%
20-09-2017,57455,TITAN14MLKBDWBTX,15,70,-55,-367%
05-12-2016,81150,ROCKETEDUBSWBTX,45,56,-11,-24%
27-06-2017,62853,PARKCITY14BTX,11,80,-69,-627%
28-05-2017,62904,BEAVERCREEK12BTX,3,12,-9,-300%
25-06-2017,60813,BERLINETTABTX,57,88,-31,-54%
24-07-2016,62856,PARKCITY15BTX,7,53,-46,-657%
12-10-2017,60150,TULIP15SKLBTX,15,46,-31,-207%
08-07-2016,53295,DIESEL15BTX,84,42,42,50%
01-09-2016,59383,IRIS15BSWBTX,33,43,-10,-30%
23-07-2016,199,PARTS,57,77,-20,-35%
27-12-2016,60705,VANGOGH15BDWBTX,87,79,8,9%
13-02-2016,70901,ROCKET11BSWBTX,35,73,-38,-109%
28-01-2015,56744,MARBLE FALLS14BTX,34,66,-32,-94%
25-07-2017,60813,BERLINETTABTX,32,1,31,97%
14-05-2017,57455,TITAN14MLKBDWBTX,78,45,33,42%
20-10-2017,83544,PR55283SALADO14,32,2,30,94%
30-08-2015,62884,LOVELAND15SBTX,78,61,17,22%
31-07-2016,60147,TULIP15BDWBTX,19,15,4,21%
09-04-2016,199,PARTS,48,34,14,29%
05-02-2015,63256,COTTONWOODSKLBTX,52,50,2,4%
16-01-2017,57455,TITAN14MLKBDWBTX,89,6,83,93%
15-06-2017,60150,TULIP15SKLBTX,83,41,42,51%
03-06-2015,61590,DINO2BTX,89,17,72,81%
08-02-2015,62875,PARKCITY15CTO1,61,74,-13,-21%
12-07-2015,61590,DINO2BTX,6,54,-48,-800%
21-04-2015,57455,TITAN14MLKBDWBTX,19,34,-15,-79%
07-10-2015,61590,DINO2BTX,59,30,29,49%
21-03-2017,62884,LOVELAND15SBTX,18,69,-51,-283%
03-02-2016,62908,BEAVERCREEK14CTO,63,40,23,37%
19-04-2015,199,PARTS,96,67,29,30%
25-08-2015,55834,JANUS14BDWBTX,78,34,44,56%
29-10-2017,52370,SALADO 14,76,100,-24,-32%
25-03-2017,63886,PANDORA15SKLBTX,100,61,39,39%
20-06-2015,55834,JANUS14BDWBTX,75,64,11,15%
12-11-2016,80787,PR53315LIVNGSTON,56,36,20,36%
11-11-2015,59384,IRIS15BDWBTX,78,88,-10,-13%
16-09-2017,57455,TITAN14MLKBDWBTX,46,53,-7,-15%
26-05-2016,199,PARTS,83,36,47,57%
24-01-2016,57455,TITAN14MLKBDWBTX,25,54,-29,-116%
29-12-2017,63276,MAPLE15SKLBTX,18,23,-5,-28%
15-12-2015,69925,CELTICCTO,67,100,-33,-49%
13-05-2017,199,PARTS,1,33,-32,-3200%
06-06-2017,61333,BERLINETTA P,2,56,-54,-2700%
29-01-2017,53295,DIESEL15BTX,19,45,-26,-137%
12-02-2016,61590,DINO2BTX,10,50,-40,-400%
03-03-2015,61590,DINO2BTX,12,99,-87,-725%
21-03-2016,199,PARTS,79,38,41,52%
03-03-2016,60150,TULIP15SKLBTX,50,82,-32,-64%
27-02-2015,61590,DINO2BTX,64,19,45,70%
06-12-2017,199,PARTS,28,66,-38,-136%
20-05-2015,62857,PARKCITY15CTO,84,32,52,62%
01-11-2017,73792,PR49577DIESEL17,9,40,-31,-344%
24-04-2017,61590,DINO2BTX,47,53,-6,-13%
08-09-2016,199,PARTS,47,20,27,57%
25-06-2015,61590,DINO2BTX,72,42,30,42%
09-01-2016,57624,CRESTEDBUTTETAA1,86,76,10,12%
19-05-2015,62911,BEAVERCREEK12FCTO,94,17,77,82%
21-03-2016,62850,PARKCITY12BTX,75,70,5,7%
21-06-2017,62853,PARKCITY14BTX,51,78,-27,-53%
19-04-2016,63276,MAPLE15SKLBTX,42,66,-24,-57%
15-07-2015,199,PARTS,10,34,-24,-240%
08-10-2015,473,NON_TIED_PERIPHERALS,23,95,-72,-313%
07-06-2015,199,PARTS,34,43,-9,-26%
17-08-2017,61590,DINO2BTX,69,83,-14,-20%
16-05-2017,60704,VANGOGH14BDWBTX,42,89,-47,-112%
05-10-2016,79321,PR52614DIESEL17,68,46,22,32%
04-01-2016,199,PARTS,29,30,-1,-3%
19-10-2016,60813,BERLINETTABTX,34,34,0,0%
02-02-2015,62877,LOVELAND14BBTX,94,77,17,18%
16-03-2016,199,PARTS,8,56,-48,-600%
20-05-2015,57494,GOLIADMLK12BTXE,71,40,31,44%
23-07-2016,199,PARTS,4,4,0,0%
19-06-2015,199,PARTS,40,75,-35,-88%
17-06-2017,62856,PARKCITY15BTX,63,5,58,92%
15-09-2015,60813,BERLINETTABTX,9,7,2,22%
21-04-2015,199,PARTS,95,7,88,93%
21-06-2016,199,PARTS,12,24,-12,-100%
11-02-2015,57640,DINO13BTX,29,28,1,3%
30-10-2016,199,PARTS,37,75,-38,-103%
09-10-2015,60150,TULIP15SKLBTX,48,24,24,50%
27-02-2017,57519,HOUSTON14BTX,60,1,59,98%
17-02-2015,57640,DINO13BTX,17,94,-77,-453%
17-06-2017,62853,PARKCITY14BTX,97,5,92,95%
11-09-2015,82322,PR47343GOLI14MLK,17,2,15,88%
19-05-2015,57640,DINO13BTX,6,83,-77,-1283%
05-07-2015,57640,DINO13BTX,39,19,20,51%
08-09-2017,68338,ROUND ROCKMLKCTO,86,39,47,55%
20-10-2016,62869,PARKCITY12CTO1,11,100,-89,-809%
20-03-2016,56160,MAGELLAN14CTO1,64,84,-20,-31%
06-01-2015,63251,BLACKWOODSKLBTX,14,88,-74,-529%
13-12-2015,60151,TULIP17SKLBTX,46,34,12,26%
10-11-2016,199,PARTS,20,54,-34,-170%
03-03-2016,56153,COLUMBUS12CTO,58,37,21,36%
18-02-2015,59383,IRIS15BSWBTX,100,30,70,70%
01-05-2015,52371,SALADO 15,76,86,-10,-13%
14-04-2016,60813,BERLINETTABTX,1,67,-66,-6600%
01-09-2016,56153,COLUMBUS12CTO,93,87,6,6%
03-08-2015,67623,MONET14SKLBTX,91,37,54,59%
25-12-2015,62853,PARKCITY14BTX,73,6,67,92%
09-09-2016,67623,MONET14SKLBTX,35,62,-27,-77%
20-11-2015,199,PARTS,37,52,-15,-41%
20-07-2015,57523,HOUSTON14TAA,27,71,-44,-163%
18-06-2015,52371,SALADO 15,23,17,6,26%
25-07-2015,63251,BLACKWOODSKLBTX,16,71,-55,-344%
14-11-2015,63276,MAPLE15SKLBTX,12,89,-77,-642%
22-02-2016,60150,TULIP15SKLBTX,97,57,40,41%
05-09-2016,58165,ECHO 15 CTO,88,99,-11,-13%
23-11-2016,62907,BEAVERCREEK14BTX,29,29,0,0%
26-01-2016,57526,HOUSTON15CTOE,68,14,54,79%
21-12-2016,71917,PRHOUSTON12CTOE2,70,6,64,91%
04-12-2016,63251,BLACKWOODSKLBTX,22,86,-64,-291%
24-03-2016,62880,LOVELAND15SCTO,29,80,-51,-176%
02-03-2016,57379,JEFFERSONBTX,87,16,71,82%
06-06-2017,60150,TULIP15SKLBTX,59,25,34,58%
13-02-2015,62884,LOVELAND15SBTX,97,99,-2,-2%
13-07-2016,199,PARTS,62,47,15,24%
26-03-2016,61339,MIRAMAR 15,67,45,22,33%
09-08-2016,56553,BRADLEYBDWBTX,9,30,-21,-233%
23-04-2016,63256,COTTONWOODSKLBTX,94,38,56,60%
02-03-2017,57499,GOLIADMLK14BTXE,88,58,30,34%
11-12-2015,65546,PR44383CRESBUTTE,86,9,77,90%
03-07-2015,75366,PR50404HOUSTN14O,83,22,61,73%
10-11-2016,199,PARTS,44,91,-47,-107%
28-05-2017,199,PARTS,50,2,48,96%
01-08-2015,56553,BRADLEYBDWBTX,44,97,-53,-120%
09-12-2016,56553,BRADLEYBDWBTX,93,67,26,28%
30-12-2017,56553,BRADLEYBDWBTX,45,87,-42,-93%
18-05-2017,62884,LOVELAND15SBTX,32,6,26,81%
22-03-2017,62884,LOVELAND15SBTX,52,75,-23,-44%
02-03-2016,64248,JAYTONBTX,83,89,-6,-7%
25-11-2015,57519,HOUSTON14BTX,34,89,-55,-162%
30-10-2015,57494,GOLIADMLK12BTXE,44,87,-43,-98%
28-06-2016,79345,PR52538PLANOM,38,22,16,42%
24-10-2016,63039,PARKCITY-P15CTO,60,98,-38,-63%
29-08-2015,199,PARTS,59,27,32,54%
10-12-2015,67623,MONET14SKLBTX,1,55,-54,-5400%
03-04-2015,199,PARTS,11,99,-88,-800%
28-09-2016,75899,PR50689HOUSTN15O,60,28,32,53%
02-11-2017,199,PARTS,4,9,-5,-125%
13-10-2017,75896,PR50677GOL14MLKA,21,22,-1,-5%
31-08-2016,73819,PR43319HOUSTON12,5,42,-37,-740%
26-05-2017,199,PARTS,1,3,-2,-200%
19-01-2017,60151,TULIP17SKLBTX,31,54,-23,-74%
10-10-2015,62884,LOVELAND15SBTX,25,97,-72,-288%
09-12-2017,199,PARTS,76,30,46,61%
11-03-2017,199,PARTS,38,6,32,84%
02-12-2017,57515,HOUSTON12CTO,24,33,-9,-38%
14-08-2016,199,PARTS,70,62,8,11%
28-06-2015,81256,PR53866PRKCTY14O,99,1,98,99%
19-06-2015,62856,PARKCITY15BTX,23,61,-38,-165%
23-08-2016,57519,HOUSTON14BTX,4,84,-80,-2000%
11-04-2017,73929,DRAXBTX,85,77,8,9%
09-03-2016,62879,LOVELAND15BBTX,62,42,20,32%
23-07-2015,59384,IRIS15BDWBTX,25,51,-26,-104%
07-04-2017,57519,HOUSTON14BTX,41,53,-12,-29%
06-10-2015,66870,PR45260CRESBUTEA,24,11,13,54%
09-05-2017,62907,BEAVERCREEK14BTX,62,98,-36,-58%
20-07-2017,57616,CRESTED BUTTEBTX,8,45,-37,-463%
17-09-2017,62856,PARKCITY15BTX,60,18,42,70%
09-12-2016,57455,TITAN14MLKBDWBTX,61,17,44,72%
19-06-2015,56746,MARBLE FALLS15BTX,48,41,7,15%
02-06-2016,59384,IRIS15BDWBTX,100,72,28,28%
06-09-2017,62881,LOVELAND14SBTX,11,35,-24,-218%
27-06-2016,62904,BEAVERCREEK12BTX,94,33,61,65%
18-05-2017,62884,LOVELAND15SBTX,58,45,13,22%
08-12-2016,64250,JAYTONSECUREBTX,29,93,-64,-221%
14-07-2016,199,PARTS,10,34,-24,-240%
21-06-2017,62904,BEAVERCREEK12BTX,13,86,-73,-562%
12-11-2016,59515,BELMONTBTX,49,2,47,96%
05-03-2016,57616,CRESTED BUTTEBTX,52,29,23,44%
17-11-2015,64248,JAYTONBTX,56,69,-13,-23%
17-12-2016,57616,CRESTED BUTTEBTX,45,40,5,11%
18-07-2017,62883,LOVELAND15BCTO,20,6,14,70%
31-05-2016,57616,CRESTED BUTTEBTX,33,13,20,61%
31-12-2017,199,PARTS,50,38,12,24%
27-04-2017,60150,TULIP15SKLBTX,72,68,4,6%
16-06-2016,60151,TULIP17SKLBTX,19,77,-58,-305%
14-05-2015,57616,CRESTED BUTTEBTX,74,61,13,18%
23-09-2016,199,PARTS,92,30,62,67%
23-11-2015,64248,JAYTONBTX,3,2,1,33%
26-03-2016,57616,CRESTED BUTTEBTX,78,55,23,29%
01-12-2017,63251,BLACKWOODSKLBTX,50,58,-8,-16%
15-02-2016,199,PARTS,3,11,-8,-267%
02-06-2016,199,PARTS,52,23,29,56%
18-10-2016,63276,MAPLE15SKLBTX,10,54,-44,-440%
15-04-2017,57515,HOUSTON12CTO,90,83,7,8%
19-01-2016,62907,BEAVERCREEK14BTX,10,19,-9,-90%
24-05-2017,199,PARTS,75,13,62,83%
06-03-2017,77831,PR45417HOUSTON14,44,78,-34,-77%
20-02-2017,55724,CEDAR14HSWBTX,70,46,24,34%
12-10-2017,199,PARTS,14,59,-45,-321%
26-09-2015,66803,SOMERSETBTX,53,13,40,75%
30-07-2015,67524,PRGOLIADMLK121,20,92,-72,-360%
13-06-2016,57494,GOLIADMLK12BTXE,14,81,-67,-479%
26-10-2017,59379,IRIS14BSWBTX,29,49,-20,-69%
18-10-2016,199,PARTS,49,100,-51,-104%
13-08-2016,199,PARTS,93,72,21,23%
16-11-2016,473,NON_TIED_PERIPHERALS,72,100,-28,-39%
06-01-2016,60705,VANGOGH15BDWBTX,63,32,31,49%
06-02-2017,57453,JANUS15HSWBTX,93,45,48,52%
18-10-2017,60705,VANGOGH15BDWBTX,52,73,-21,-40%
02-08-2016,65546,PR44383CRESBUTTE,58,89,-31,-53%
22-08-2015,62907,BEAVERCREEK14BTX,95,20,75,79%
23-04-2017,56553,BRADLEYBDWBTX,69,26,43,62%
09-12-2017,199,PARTS,28,99,-71,-254%
30-07-2016,62856,PARKCITY15BTX,67,37,30,45%
06-12-2016,75364,PR50302HOUSTN14O,10,36,-26,-260%
04-06-2016,64250,JAYTONSECUREBTX,64,92,-28,-44%
08-04-2017,57190,ERIKSSON14BTX,84,98,-14,-17%
20-09-2016,60705,VANGOGH15BDWBTX,10,26,-16,-160%
12-12-2016,63886,PANDORA15SKLBTX,76,25,51,67%
01-10-2016,61341,MIRAMAR 17,16,2,14,88%
03-08-2015,64248,JAYTONBTX,15,58,-43,-287%
16-08-2015,57616,CRESTED BUTTEBTX,39,60,-21,-54%
06-12-2017,60149,TULIP14SKLBTX,86,55,31,36%
02-03-2016,68343,ROUNDROCKMLKCTO1,7,24,-17,-243%
26-05-2017,57616,CRESTED BUTTEBTX,64,95,-31,-48%
22-11-2016,36029,SLINKY,42,25,17,40%
13-04-2016,55724,CEDAR14HSWBTX,54,35,19,35%
04-03-2016,69925,CELTICCTO,48,53,-5,-10%
26-05-2016,60150,TULIP15SKLBTX,73,91,-18,-25%
15-04-2016,56553,BRADLEYBDWBTX,75,55,20,27%
03-10-2016,57527,HOUSTON15CTO,40,30,10,25%
03-09-2017,60150,TULIP15SKLBTX,9,8,1,11%
11-05-2017,57494,GOLIADMLK12BTXE,89,87,2,2%
25-08-2016,68338,ROUND ROCKMLKCTO,69,98,-29,-42%
07-07-2017,60150,TULIP15SKLBTX,45,35,10,22%
27-03-2016,61333,BERLINETTA P,92,74,18,20%
02-05-2017,36029,SLINKY,33,72,-39,-118%
06-04-2016,55724,CEDAR14HSWBTX,50,17,33,66%
15-08-2016,53923,COLUMBUS12BTX,12,93,-81,-675%
19-11-2017,32575,BRUTUS,15,57,-42,-280%
11-05-2015,56553,BRADLEYBDWBTX,78,37,41,53%
02-11-2016,56553,BRADLEYBDWBTX,7,35,-28,-400%
12-09-2017,62854,PARKCITY14CTO,61,93,-32,-52%
09-08-2015,199,PARTS,62,56,6,10%
04-09-2015,473,NON_TIED_PERIPHERALS,89,96,-7,-8%
08-03-2017,62881,LOVELAND14SBTX,57,37,20,35%
07-01-2015,60705,VANGOGH15BDWBTX,21,90,-69,-329%
03-05-2016,62904,BEAVERCREEK12BTX,40,13,27,68%
14-07-2016,57494,GOLIADMLK12BTXE,96,60,36,38%
14-01-2016,199,PARTS,7,48,-41,-586%
28-01-2015,57515,HOUSTON12CTO,26,42,-16,-62%
18-08-2017,63256,COTTONWOODSKLBTX,42,69,-27,-64%
17-10-2015,199,PARTS,39,20,19,49%
07-07-2015,62881,LOVELAND14SBTX,11,69,-58,-527%
24-11-2017,63256,COTTONWOODSKLBTX,13,32,-19,-146%
11-04-2016,59380,IRIS14BDWBTX,76,93,-17,-22%
14-01-2015,60704,VANGOGH14BDWBTX,77,40,37,48%
27-03-2015,60705,VANGOGH15BDWBTX,32,2,30,94%
17-08-2015,199,PARTS,27,94,-67,-248%
08-08-2015,62883,LOVELAND15BCTO,98,99,-1,-1%
16-04-2015,67623,MONET14SKLBTX,41,82,-41,-100%
11-08-2015,62856,PARKCITY15BTX,32,53,-21,-66%
06-04-2015,57494,GOLIADMLK12BTXE,73,3,70,96%
28-03-2016,67623,MONET14SKLBTX,96,51,45,47%
12-05-2017,63276,MAPLE15SKLBTX,19,42,-23,-121%
12-06-2016,60150,TULIP15SKLBTX,47,74,-27,-57%
25-06-2016,62856,PARKCITY15BTX,98,24,74,76%
07-08-2015,62877,LOVELAND14BBTX,31,18,13,42%
24-12-2017,57515,HOUSTON12CTO,75,9,66,88%
26-07-2017,62857,PARKCITY15CTO,57,58,-1,-2%
30-04-2017,62856,PARKCITY15BTX,15,66,-51,-340%
07-02-2015,60705,VANGOGH15BDWBTX,53,21,32,60%
30-01-2015,61949,LIVINGSTONECTO,16,1,15,94%
27-07-2015,53539,ALPINE 14,59,29,30,51%
12-02-2016,199,PARTS,92,19,73,79%
02-09-2015,59384,IRIS15BDWBTX,85,22,63,74%
02-03-2016,36029,SLINKY,51,60,-9,-18%
10-03-2015,62879,LOVELAND15BBTX,72,19,53,74%
28-02-2016,199,PARTS,52,6,46,88%
02-04-2016,60149,TULIP14SKLBTX,70,4,66,94%
04-05-2017,59384,IRIS15BDWBTX,76,56,20,26%
16-08-2017,60705,VANGOGH15BDWBTX,27,47,-20,-74%
06-06-2015,52371,SALADO 15,39,89,-50,-128%
18-10-2016,59861,SILVEROAKBTX,88,33,55,63%
04-08-2015,199,PARTS,37,20,17,46%
30-04-2015,57368,FIGTREECTO,79,13,66,84%
13-03-2017,67623,MONET14SKLBTX,17,11,6,35%
14-03-2015,57494,GOLIADMLK12BTXE,93,26,67,72%
05-05-2016,199,PARTS,37,61,-24,-65%
29-08-2016,63045,PARKCITYP15TAA,64,85,-21,-33%
10-07-2017,61333,BERLINETTA P,23,21,2,9%
20-08-2017,199,PARTS,93,49,44,47%
01-12-2016,62883,LOVELAND15BCTO,6,29,-23,-383%
03-03-2017,199,PARTS,10,19,-9,-90%
28-10-2015,60150,TULIP15SKLBTX,58,57,1,2%
27-12-2017,57494,GOLIADMLK12BTXE,51,13,38,75%
01-05-2015,199,PARTS,4,41,-37,-925%
16-10-2016,199,PARTS,70,35,35,50%
18-09-2015,199,PARTS,7,43,-36,-514%
15-01-2015,60704,VANGOGH14BDWBTX,6,98,-92,-1533%
23-04-2016,62877,LOVELAND14BBTX,75,29,46,61%
07-02-2016,60704,VANGOGH14BDWBTX,63,30,33,52%
06-11-2015,63886,PANDORA15SKLBTX,30,27,3,10%
22-05-2016,52371,SALADO 15,34,32,2,6%
23-10-2017,57529,HOUSTON15TAA,84,87,-3,-4%
22-06-2016,59384,IRIS15BDWBTX,49,5,44,90%
19-04-2017,61239,REDWOODMLKBSWBTX,34,34,0,0%
01-02-2016,59861,SILVEROAKBTX,29,37,-8,-28%
24-03-2017,60148,TULIP17BDWBTX,5,78,-73,-1460%
07-05-2015,199,PARTS,57,12,45,79%
05-11-2015,62884,LOVELAND15SBTX,2,78,-76,-3800%
31-12-2015,59384,IRIS15BDWBTX,52,23,29,56%
07-06-2016,61333,BERLINETTA P,60,74,-14,-23%
18-11-2015,59861,SILVEROAKBTX,36,62,-26,-72%
28-07-2015,75573,PR50536ERIKSNATG,55,53,2,4%
20-10-2016,60151,TULIP17SKLBTX,34,91,-57,-168%
10-01-2017,199,PARTS,19,44,-25,-132%
24-05-2017,60705,VANGOGH15BDWBTX,23,42,-19,-83%
30-03-2016,62884,LOVELAND15SBTX,11,69,-58,-527%
25-04-2016,63396,ECHO 15 MLK BTX,61,71,-10,-16%
23-03-2015,69925,CELTICCTO,82,54,28,34%
20-06-2015,60148,TULIP17BDWBTX,7,54,-47,-671%
07-03-2015,81389,PR34781LIVGSTONE,7,98,-91,-1300%
04-05-2015,62881,LOVELAND14SBTX,79,63,16,20%
25-01-2017,199,PARTS,30,65,-35,-117%
01-11-2016,60704,VANGOGH14BDWBTX,56,11,45,80%
31-01-2016,81203,PR53665PKCTYP15O,30,34,-4,-13%
28-06-2016,63396,ECHO 15 MLK BTX,73,51,22,30%
12-12-2016,62907,BEAVERCREEK14BTX,29,41,-12,-41%
28-05-2017,61590,DINO2BTX,17,79,-62,-365%
23-03-2017,83232,PR35512BOLDPEAK2,75,62,13,17%
21-02-2015,64248,JAYTONBTX,8,8,0,0%
11-03-2016,62880,LOVELAND15SCTO,98,27,71,72%
27-01-2017,199,PARTS,64,66,-2,-3%
27-11-2016,61239,REDWOODMLKBSWBTX,41,47,-6,-15%
17-04-2016,61590,DINO2BTX,82,43,39,48%
16-02-2017,57495,GOLIADMLK12CTOE,26,13,13,50%
08-10-2017,63395,ECHO 13 MLK CTO,91,5,86,95%
01-08-2015,63397,ECHO 15 MLK CTO,65,91,-26,-40%
16-02-2017,63396,ECHO 15 MLK BTX,63,45,18,29%
01-01-2015,79997,PR46242HOUSTON14,9,22,-13,-144%
23-06-2015,63095,MERIDIANBTX,65,70,-5,-8%
08-03-2017,80773,PR53407JAYTON,55,49,6,11%
21-06-2017,59384,IRIS15BDWBTX,93,49,44,47%
19-09-2016,59384,IRIS15BDWBTX,73,59,14,19%
17-07-2017,199,PARTS,6,25,-19,-317%
05-02-2016,78618,PR54424JYTNSECTO,68,50,18,26%
02-09-2017,199,PARTS,57,74,-17,-30%
24-05-2015,57455,TITAN14MLKBDWBTX,79,4,75,95%
01-11-2015,84932,PR36845BOLDPEAK2,26,98,-72,-277%
26-12-2016,59379,IRIS14BSWBTX,84,13,71,85%
13-12-2016,61590,DINO2BTX,81,99,-18,-22%
15-09-2017,55731,CEDAR15AMDBTX,42,44,-2,-5%
16-11-2016,199,PARTS,98,89,9,9%
02-05-2015,54142,TESTAROSSA P,6,56,-50,-833%
26-07-2015,199,PARTS,76,20,56,74%
04-09-2016,62857,PARKCITY15CTO,6,50,-44,-733%
04-11-2016,61590,DINO2BTX,35,43,-8,-23%
10-10-2016,57494,GOLIADMLK12BTXE,89,58,31,35%
16-05-2015,59670,PLANOBCTO,33,67,-34,-103%
10-10-2017,55731,CEDAR15AMDBTX,1,56,-55,-5500%
04-08-2016,61590,DINO2BTX,5,43,-38,-760%
31-01-2015,199,PARTS,83,39,44,53%
09-09-2015,62887,LOVELAND14FSBTX,78,45,33,42%
01-12-2016,59381,IRIS14SKLBTX,25,99,-74,-296%
25-10-2016,55731,CEDAR15AMDBTX,12,28,-16,-133%
29-12-2016,60706,VANGOGH14SKLBTX,15,44,-29,-193%
07-11-2015,68337,ROUND ROCKMLKBTX,3,41,-38,-1267%
19-11-2015,60150,TULIP15SKLBTX,20,54,-34,-170%
26-06-2016,38851,SQUEEZE,97,14,83,86%
01-03-2017,82959,PR47602LOVELNS15,19,47,-28,-147%
04-09-2016,62881,LOVELAND14SBTX,31,60,-29,-94%
07-02-2016,57527,HOUSTON15CTO,5,75,-70,-1400%
11-12-2017,62884,LOVELAND15SBTX,53,69,-16,-30%
16-10-2016,59383,IRIS15BSWBTX,64,6,58,91%
21-02-2016,199,PARTS,16,99,-83,-519%
01-05-2015,199,PARTS,14,82,-68,-486%
08-05-2016,57617,CRESTED BUTTECTO,91,88,3,3%
21-09-2016,62905,BEAVERCREEK12CTO,75,81,-6,-8%
26-08-2015,199,PARTS,44,3,41,93%
17-07-2017,53512,GOLIAD 14,27,12,15,56%
28-02-2016,56746,MARBLE FALLS15BTX,35,12,23,66%
26-09-2015,60147,TULIP15BDWBTX,1,91,-90,-9000%
01-11-2017,60705,VANGOGH15BDWBTX,12,53,-41,-342%
31-03-2015,60150,TULIP15SKLBTX,23,75,-52,-226%
02-04-2015,57624,CRESTEDBUTTETAA1,72,98,-26,-36%
05-11-2015,56746,MARBLE FALLS15BTX,5,57,-52,-1040%
21-12-2017,64248,JAYTONBTX,99,68,31,31%
27-05-2017,62904,BEAVERCREEK12BTX,29,75,-46,-159%
28-12-2017,60151,TULIP17SKLBTX,10,23,-13,-130%
26-08-2017,60150,TULIP15SKLBTX,35,75,-40,-114%
20-04-2017,199,PARTS,32,70,-38,-119%
28-09-2017,61590,DINO2BTX,23,40,-17,-74%
20-01-2016,199,PARTS,69,52,17,25%
19-12-2017,55731,CEDAR15AMDBTX,40,22,18,45%
20-11-2017,56746,MARBLE FALLS15BTX,13,62,-49,-377%
15-08-2016,60812,VENENOBTX,45,29,16,36%
12-01-2015,57527,HOUSTON15CTO,50,43,7,14%
21-05-2015,61590,DINO2BTX,94,25,69,73%
20-10-2015,57519,HOUSTON14BTX,38,66,-28,-74%
21-01-2017,55731,CEDAR15AMDBTX,37,30,7,19%
12-07-2016,69477,PR46811MAGELLXFR,100,13,87,87%
25-09-2015,57453,JANUS15HSWBTX,58,49,9,16%
19-05-2017,62854,PARKCITY14CTO,46,99,-53,-115%
08-02-2015,60822,BOLDPEAK2BTX,96,29,67,70%
20-05-2017,56746,MARBLE FALLS15BTX,91,64,27,30%
24-05-2015,60150,TULIP15SKLBTX,59,12,47,80%
03-11-2016,199,PARTS,43,83,-40,-93%
26-04-2017,199,PARTS,93,30,63,68%
13-09-2016,64248,JAYTONBTX,27,40,-13,-48%
13-11-2015,59379,IRIS14BSWBTX,67,100,-33,-49%
28-07-2016,199,PARTS,48,32,16,33%
17-04-2015,61341,MIRAMAR 17,17,98,-81,-476%
08-01-2015,82698,PR47473PARKCTY14,75,83,-8,-11%
17-07-2016,57283,COTTONWOODBDWBTX,11,39,-28,-255%
20-04-2016,57519,HOUSTON14BTX,22,73,-51,-232%
17-03-2017,62904,BEAVERCREEK12BTX,55,86,-31,-56%
20-03-2015,57283,COTTONWOODBDWBTX,65,73,-8,-12%
14-09-2016,57519,HOUSTON14BTX,84,28,56,67%
26-06-2017,62877,LOVELAND14BBTX,22,1,21,95%
17-07-2017,63395,ECHO 13 MLK CTO,84,44,40,48%
20-11-2016,60705,VANGOGH15BDWBTX,54,39,15,28%
29-04-2017,74767,PR50079MARFALS14,30,76,-46,-153%
28-08-2015,53510,GOLIAD 12,12,6,6,50%
13-12-2016,60705,VANGOGH15BDWBTX,2,71,-69,-3450%
02-02-2017,59381,IRIS14SKLBTX,69,94,-25,-36%
09-06-2016,57527,HOUSTON15CTO,97,79,18,19%
10-04-2015,60705,VANGOGH15BDWBTX,62,33,29,47%
14-03-2017,60705,VANGOGH15BDWBTX,52,87,-35,-67%
24-11-2017,60150,TULIP15SKLBTX,48,72,-24,-50%
27-06-2016,62854,PARKCITY14CTO,37,84,-47,-127%
21-11-2015,60705,VANGOGH15BDWBTX,52,16,36,69%
08-02-2016,61173,JASBSW20BTX,88,29,59,67%
30-10-2015,199,PARTS,87,69,18,21%
21-12-2017,199,PARTS,57,49,8,14%
15-03-2017,199,PARTS,99,72,27,27%
05-10-2015,57283,COTTONWOODBDWBTX,3,80,-77,-2567%
11-07-2015,57191,ERIKSSON14CTO,34,67,-33,-97%
20-02-2016,57623,CRESTEDBUTTECTO1,21,71,-50,-238%
17-04-2015,199,PARTS,73,65,8,11%
29-10-2016,74766,PR50034LIVNGSTON,35,52,-17,-49%
08-04-2016,60150,TULIP15SKLBTX,25,86,-61,-244%
18-04-2016,62884,LOVELAND15SBTX,81,23,58,72%
12-07-2017,60151,TULIP17SKLBTX,64,1,63,98%
27-07-2016,63253,REDWOODSKLBTX,55,50,5,9%
01-03-2016,57519,HOUSTON14BTX,61,15,46,75%
18-02-2017,59383,IRIS15BSWBTX,53,63,-10,-19%
24-02-2015,57283,COTTONWOODBDWBTX,76,49,27,36%
17-06-2016,59379,IRIS14BSWBTX,31,19,12,39%
26-04-2016,199,PARTS,37,62,-25,-68%
22-02-2017,62856,PARKCITY15BTX,3,95,-92,-3067%
19-12-2015,60147,TULIP15BDWBTX,20,71,-51,-255%
18-05-2017,57521,HOUSTON14CTO,20,18,2,10%
20-06-2015,53292,DIESEL 17,1,56,-55,-5500%
19-02-2016,60707,VANGOGH15SKLBTX,9,22,-13,-144%
16-05-2015,60705,VANGOGH15BDWBTX,6,82,-76,-1267%
07-02-2016,63399,ECHO 17 MLK CTO,11,52,-41,-373%
30-05-2017,62877,LOVELAND14BBTX,2,19,-17,-850%
27-02-2016,57617,CRESTED BUTTECTO,92,16,76,83%
31-12-2016,62883,LOVELAND15BCTO,11,75,-64,-582%
27-10-2017,60146,TULIP14BDWBTX,53,62,-9,-17%
29-06-2015,52332,SALADO14BTX,26,42,-16,-62%
25-08-2015,60154,TULIP17AMDBTX,10,63,-53,-530%
06-01-2017,57497,GOLIADMLK14CTOE,98,33,65,66%
27-07-2015,63886,PANDORA15SKLBTX,61,95,-34,-56%
15-04-2017,75902,PR50642MARFALS14,97,99,-2,-2%
03-11-2017,60153,TULIP15AMDBTX,14,44,-30,-214%
29-05-2017,60152,TULIP14AMDBTX,65,63,2,3%
05-05-2015,199,PARTS,66,26,40,61%
25-08-2015,60146,TULIP14BDWBTX,59,89,-30,-51%
07-07-2016,57495,GOLIADMLK12CTOE,15,20,-5,-33%
21-02-2016,57283,COTTONWOODBDWBTX,81,18,63,78%
23-12-2016,57495,GOLIADMLK12CTOE,52,59,-7,-13%
09-08-2015,60151,TULIP17SKLBTX,25,98,-73,-292%
11-04-2015,60813,BERLINETTABTX,73,51,22,30%
07-08-2016,64248,JAYTONBTX,2,52,-50,-2500%
04-08-2017,54142,TESTAROSSA P,49,81,-32,-65%
14-08-2017,79972,PR53030ERIKSNATG,37,21,16,43%
31-10-2016,63253,REDWOODSKLBTX,90,72,18,20%
08-07-2017,70533,PR47417DIESEL17,80,64,16,20%
02-01-2017,60149,TULIP14SKLBTX,10,45,-35,-350%
12-11-2017,66803,SOMERSETBTX,82,6,76,93%
12-05-2015,199,PARTS,17,29,-12,-71%
03-11-2017,60150,TULIP15SKLBTX,96,14,82,85%
01-07-2016,77339,PR51386HOUSTN14O,58,79,-21,-36%
01-06-2017,52370,SALADO 14,61,100,-39,-64%
08-12-2016,62907,BEAVERCREEK14BTX,81,63,18,22%
17-07-2015,60146,TULIP14BDWBTX,42,86,-44,-105%
21-03-2015,60147,TULIP15BDWBTX,31,78,-47,-152%
30-07-2017,199,PARTS,93,90,3,3%
29-10-2015,63886,PANDORA15SKLBTX,24,14,10,42%
08-09-2015,60149,TULIP14SKLBTX,51,40,11,22%
03-07-2015,52332,SALADO14BTX,96,22,74,77%
30-04-2017,52356,SALADO15CTO1,32,9,23,72%
02-12-2015,66803,SOMERSETBTX,13,18,-5,-38%
12-10-2015,59380,IRIS14BDWBTX,43,73,-30,-70%
05-04-2017,59379,IRIS14BSWBTX,23,73,-50,-217%
07-01-2016,199,PARTS,2,79,-77,-3850%
11-05-2017,57494,GOLIADMLK12BTXE,32,48,-16,-50%
01-07-2016,68977,PRGOLIADMLK144,94,2,92,98%
13-05-2017,63274,MAPLE14SKLBTX,56,65,-9,-16%
04-08-2015,55728,CEDAR15BDWBTX,10,30,-20,-200%
09-11-2016,64248,JAYTONBTX,5,78,-73,-1460%
26-01-2015,57529,HOUSTON15TAA,15,68,-53,-353%
20-07-2017,60705,VANGOGH15BDWBTX,14,89,-75,-536%
08-01-2016,61590,DINO2BTX,77,28,49,64%
24-02-2017,199,PARTS,35,93,-58,-166%
21-03-2016,57497,GOLIADMLK14CTOE,44,58,-14,-32%
31-03-2015,53850,DIESEL15CTO,22,80,-58,-264%
21-01-2016,199,PARTS,92,99,-7,-8%
07-10-2017,62907,BEAVERCREEK14BTX,30,72,-42,-140%
15-08-2015,57623,CRESTEDBUTTECTO1,85,1,84,99%
19-03-2017,62892,LOVELAND15FBCTO,32,75,-43,-134%
31-05-2016,63401,ECHO 13 MLKFCTO,95,83,12,13%
04-02-2016,60813,BERLINETTABTX,80,77,3,4%
12-03-2016,61590,DINO2BTX,44,88,-44,-100%
12-08-2017,199,PARTS,5,93,-88,-1760%
19-01-2015,59383,IRIS15BSWBTX,16,99,-83,-519%
27-12-2016,199,PARTS,23,47,-24,-104%
24-05-2017,199,PARTS,97,93,4,4%
21-08-2015,66803,SOMERSETBTX,9,86,-77,-856%
14-06-2015,57624,CRESTEDBUTTETAA1,15,12,3,20%
19-02-2017,62856,PARKCITY15BTX,91,90,1,1%
23-03-2015,59379,IRIS14BSWBTX,59,50,9,15%
27-05-2016,473,NON_TIED_PERIPHERALS,29,39,-10,-34%
20-02-2015,66803,SOMERSETBTX,29,48,-19,-66%
28-05-2015,66803,SOMERSETBTX,32,87,-55,-172%
29-10-2017,60150,TULIP15SKLBTX,65,65,0,0%
22-06-2017,59384,IRIS15BDWBTX,75,80,-5,-7%
21-03-2016,66947,PRHOUSTON14CTOE1,26,58,-32,-123%
07-04-2015,63886,PANDORA15SKLBTX,67,27,40,60%
14-03-2015,60146,TULIP14BDWBTX,63,58,5,8%
28-03-2016,60705,VANGOGH15BDWBTX,84,79,5,6%
29-07-2015,199,PARTS,56,52,4,7%
28-05-2017,60813,BERLINETTABTX,83,50,33,40%
15-10-2016,60812,VENENOBTX,71,96,-25,-35%
04-05-2016,66803,SOMERSETBTX,1,37,-36,-3600%
28-06-2017,60151,TULIP17SKLBTX,37,65,-28,-76%
15-03-2017,66803,SOMERSETBTX,52,87,-35,-67%
24-02-2015,59860,SILVERTONBTX,96,69,27,28%
04-09-2016,60151,TULIP17SKLBTX,14,21,-7,-50%
07-06-2016,84467,PR55610RNDRCKMLK,1,90,-89,-8900%
21-09-2016,59860,SILVERTONBTX,69,51,18,26%
14-12-2017,60151,TULIP17SKLBTX,79,36,43,54%
23-11-2017,56746,MARBLE FALLS15BTX,83,71,12,14%
10-09-2015,52375,SALADO 14 CTO,95,75,20,21%
04-07-2017,57527,HOUSTON15CTO,67,55,12,18%
30-11-2017,60705,VANGOGH15BDWBTX,95,89,6,6%
06-09-2015,52371,SALADO 15,69,55,14,20%
31-01-2016,57494,GOLIADMLK12BTXE,38,18,20,53%
05-08-2016,60150,TULIP15SKLBTX,93,74,19,20%
14-04-2017,60705,VANGOGH15BDWBTX,12,90,-78,-650%
23-04-2017,73756,PR49515ERIKSNATG,100,31,69,69%
01-10-2016,63397,ECHO 15 MLK CTO,94,52,42,45%
12-02-2017,59383,IRIS15BSWBTX,84,57,27,32%
19-09-2017,57527,HOUSTON15CTO,93,14,79,85%
15-11-2015,68337,ROUND ROCKMLKBTX,94,64,30,32%
14-05-2017,66947,PRHOUSTON14CTOE1,98,47,51,52%
